All Donation Service Areas,All Time,All Ethnicities,All Ages,Pediatric,Adult
"
","
","
",96119,1160,94959
"
","
",White Non-Hispanic,34221,480,33741
"
","
",Black Non-Hispanic,29925,216,29709
"
","
",Hispanic/Latino,20916,337,20579
"
","
",Asian Non-Hispanic,8879,74,8805
"
","
",American Indian/Alaska Native Non-Hispanic,795,11,784
"
","
",Pacific Islander Non-Hispanic,586,9,577
"
","
",Multiracial Non-Hispanic,797,33,764
"
",< 30 Days,All Ethnicities,4078,89,3989
"
","
",White Non-Hispanic,1622,35,1587
"
","
",Black Non-Hispanic,1227,15,1212
"
","
",Hispanic/Latino,855,28,827
"
","
",Asian Non-Hispanic,284,5,279
"
","
",American Indian/Alaska Native Non-Hispanic,34,1,33
"
","
",Pacific Islander Non-Hispanic,17,1,16
"
","
",Multiracial Non-Hispanic,39,4,35
"
",30 to < 90 Days,All Ethnicities,6581,150,6431
"
","
",White Non-Hispanic,2596,59,2537
"
","
",Black Non-Hispanic,2018,19,1999
"
","
",Hispanic/Latino,1326,58,1268
"
","
",Asian Non-Hispanic,502,10,492
"
","
",American Indian/Alaska Native Non-Hispanic,51,0,51
"
","
",Pacific Islander Non-Hispanic,33,1,32
"
","
",Multiracial Non-Hispanic,55,3,52
"
",90 Days to < 6 Months,All Ethnicities,8038,140,7898
"
","
",White Non-Hispanic,3176,58,3118
"
","
",Black Non-Hispanic,2446,26,2420
"
","
",Hispanic/Latino,1634,42,1592
"
","
",Asian Non-Hispanic,617,6,611
"
","
",American Indian/Alaska Native Non-Hispanic,64,2,62
"
","
",Pacific Islander Non-Hispanic,35,1,34
"
","
",Multiracial Non-Hispanic,66,5,61
"
",6 Months to < 1 Year,All Ethnicities,14842,221,14621
"
","
",White Non-Hispanic,5655,83,5572
"
","
",Black Non-Hispanic,4608,46,4562
"
","
",Hispanic/Latino,3008,62,2946
"
","
",Asian Non-Hispanic,1258,17,1241
"
","
",American Indian/Alaska Native Non-Hispanic,130,2,128
"
","
",Pacific Islander Non-Hispanic,74,1,73
"
","
",Multiracial Non-Hispanic,109,10,99
"
",1 Year to < 2 Years,All Ethnicities,21456,239,21217
"
","
",White Non-Hispanic,7923,105,7818
"
","
","
","
","
","
"
"
","
",Black Non-Hispanic,6758,53,6705
"
","
",Hispanic/Latino,4414,60,4354
"
","
",Asian Non-Hispanic,1931,13,1918
"
","
",American Indian/Alaska Native Non-Hispanic,159,2,157
"
","
",Pacific Islander Non-Hispanic,119,3,116
"
","
",Multiracial Non-Hispanic,152,3,149
"
",2 Years to < 3 Years,All Ethnicities,13247,118,13129
"
","
",White Non-Hispanic,4711,54,4657
"
","
",Black Non-Hispanic,4115,23,4092
"
","
",Hispanic/Latino,2853,30,2823
"
","
",Asian Non-Hispanic,1241,5,1236
"
","
",American Indian/Alaska Native Non-Hispanic,117,1,116
"
","
",Pacific Islander Non-Hispanic,87,0,87
"
","
",Multiracial Non-Hispanic,123,5,118
"
",3 Years to < 5 Years,All Ethnicities,16479,112,16367
"
","
",White Non-Hispanic,5252,52,5200
"
","
",Black Non-Hispanic,5076,18,5058
"
","
",Hispanic/Latino,3970,31,3939
"
","
",Asian Non-Hispanic,1767,6,1761
"
","
",American Indian/Alaska Native Non-Hispanic,143,3,140
"
","
",Pacific Islander Non-Hispanic,120,1,119
"
","
",Multiracial Non-Hispanic,151,1,150
"
",5 or More Years,All Ethnicities,11398,91,11307
"
","
",White Non-Hispanic,3286,34,3252
"
","
",Black Non-Hispanic,3677,16,3661
"
","
",Hispanic/Latino,2856,26,2830
"
","
",Asian Non-Hispanic,1279,12,1267
"
","
",American Indian/Alaska Native Non-Hispanic,97,0,97
"
","
",Pacific Islander Non-Hispanic,101,1,100
"
","
",Multiracial Non-Hispanic,102,2,100
ALOB-OP1 Legacy of Hope,All Time,All Ethnicities,1074,11,1063
"
","
",White Non-Hispanic,374,5,369
"
","
",Black Non-Hispanic,670,5,665
"
","
",Hispanic/Latino,15,1,14
"
","
",Asian Non-Hispanic,12,0,12
"
","
",American Indian/Alaska Native Non-Hispanic,2,0,2
"
","
",Multiracial Non-Hispanic,1,0,1
"
",< 30 Days,All Ethnicities,31,1,30
"
","
",White Non-Hispanic,16,0,16
"
","
",Black Non-Hispanic,15,1,14
"
",30 to < 90 Days,All Ethnicities,110,3,107
"
","
","
","
","
","
"
"
","
",White Non-Hispanic,37,2,35
"
","
",Black Non-Hispanic,69,1,68
"
","
",Hispanic/Latino,2,0,2
"
","
",Asian Non-Hispanic,2,0,2
"
",90 Days to < 6 Months,All Ethnicities,100,2,98
"
","
",White Non-Hispanic,37,1,36
"
","
",Black Non-Hispanic,58,0,58
"
","
",Hispanic/Latino,2,1,1
"
","
",Asian Non-Hispanic,3,0,3
"
",6 Months to < 1 Year,All Ethnicities,201,4,197
"
","
",White Non-Hispanic,77,2,75
"
","
",Black Non-Hispanic,119,2,117
"
","
",Hispanic/Latino,3,0,3
"
","
",Asian Non-Hispanic,1,0,1
"
","
",American Indian/Alaska Native Non-Hispanic,1,0,1
"
",1 Year to < 2 Years,All Ethnicities,255,0,255
"
","
",White Non-Hispanic,90,0,90
"
","
",Black Non-Hispanic,156,0,156
"
","
",Hispanic/Latino,4,0,4
"
","
",Asian Non-Hispanic,4,0,4
"
","
",American Indian/Alaska Native Non-Hispanic,1,0,1
"
",2 Years to < 3 Years,All Ethnicities,113,0,113
"
","
",White Non-Hispanic,45,0,45
"
","
",Black Non-Hispanic,64,0,64
"
","
",Hispanic/Latino,2,0,2
"
","
",Asian Non-Hispanic,1,0,1
"
","
",Multiracial Non-Hispanic,1,0,1
"
",3 Years to < 5 Years,All Ethnicities,158,0,158
"
","
",White Non-Hispanic,48,0,48
"
","
",Black Non-Hispanic,108,0,108
"
","
",Hispanic/Latino,1,0,1
"
","
",Asian Non-Hispanic,1,0,1
"
",5 or More Years,All Ethnicities,106,1,105
"
","
",White Non-Hispanic,24,0,24
"
","
",Black Non-Hispanic,81,1,80
"
","
",Hispanic/Latino,1,0,1
AROR-OP1 Arkansas Regional Organ Recovery Agency,All Time,All Ethnicities,164,10,154
"
","
",White Non-Hispanic,41,5,36
"
","
",Black Non-Hispanic,88,3,85
"
","
",Hispanic/Latino,13,2,11
"
","
",Asian Non-Hispanic,5,0,5
"
","
","
","
","
","
"
"
","
",Pacific Islander Non-Hispanic,1,0,1
"
","
",Multiracial Non-Hispanic,16,0,16
"
",< 30 Days,All Ethnicities,5,0,5
"
","
",White Non-Hispanic,1,0,1
"
","
",Black Non-Hispanic,3,0,3
"
","
",Hispanic/Latino,1,0,1
"
",30 to < 90 Days,All Ethnicities,20,0,20
"
","
",White Non-Hispanic,7,0,7
"
","
",Black Non-Hispanic,9,0,9
"
","
",Hispanic/Latino,1,0,1
"
","
",Multiracial Non-Hispanic,3,0,3
"
",90 Days to < 6 Months,All Ethnicities,30,3,27
"
","
",White Non-Hispanic,7,0,7
"
","
",Black Non-Hispanic,15,1,14
"
","
",Hispanic/Latino,6,2,4
"
","
",Asian Non-Hispanic,1,0,1
"
","
",Multiracial Non-Hispanic,1,0,1
"
",6 Months to < 1 Year,All Ethnicities,37,2,35
"
","
",White Non-Hispanic,12,2,10
"
","
",Black Non-Hispanic,18,0,18
"
","
",Hispanic/Latino,2,0,2
"
","
",Asian Non-Hispanic,4,0,4
"
","
",Multiracial Non-Hispanic,1,0,1
"
",1 Year to < 2 Years,All Ethnicities,39,3,36
"
","
",White Non-Hispanic,9,2,7
"
","
",Black Non-Hispanic,23,1,22
"
","
",Hispanic/Latino,1,0,1
"
","
",Multiracial Non-Hispanic,6,0,6
"
",2 Years to < 3 Years,All Ethnicities,11,2,9
"
","
",White Non-Hispanic,1,1,0
"
","
",Black Non-Hispanic,8,1,7
"
","
",Hispanic/Latino,1,0,1
"
","
",Multiracial Non-Hispanic,1,0,1
"
",3 Years to < 5 Years,All Ethnicities,15,0,15
"
","
",White Non-Hispanic,3,0,3
"
","
",Black Non-Hispanic,8,0,8
"
","
",Hispanic/Latino,1,0,1
"
","
",Multiracial Non-Hispanic,3,0,3
"
",5 or More Years,All Ethnicities,7,0,7
"
","
",White Non-Hispanic,1,0,1
"
","
",Black Non-Hispanic,4,0,4
"
","
","
","
","
","
"
"
","
",Pacific Islander Non-Hispanic,1,0,1
"
","
",Multiracial Non-Hispanic,1,0,1
AZOB-OP1 Donor Network of Arizona,All Time,All Ethnicities,1250,8,1242
"
","
",White Non-Hispanic,473,0,473
"
","
",Black Non-Hispanic,151,1,150
"
","
",Hispanic/Latino,403,5,398
"
","
",Asian Non-Hispanic,95,0,95
"
","
",American Indian/Alaska Native Non-Hispanic,110,1,109
"
","
",Pacific Islander Non-Hispanic,7,0,7
"
","
",Multiracial Non-Hispanic,11,1,10
"
",< 30 Days,All Ethnicities,82,0,82
"
","
",White Non-Hispanic,29,0,29
"
","
",Black Non-Hispanic,9,0,9
"
","
",Hispanic/Latino,33,0,33
"
","
",Asian Non-Hispanic,9,0,9
"
","
",American Indian/Alaska Native Non-Hispanic,1,0,1
"
","
",Multiracial Non-Hispanic,1,0,1
"
",30 to < 90 Days,All Ethnicities,102,1,101
"
","
",White Non-Hispanic,38,0,38
"
","
",Black Non-Hispanic,11,0,11
"
","
",Hispanic/Latino,35,1,34
"
","
",Asian Non-Hispanic,12,0,12
"
","
",American Indian/Alaska Native Non-Hispanic,5,0,5
"
","
",Multiracial Non-Hispanic,1,0,1
"
",90 Days to < 6 Months,All Ethnicities,162,0,162
"
","
",White Non-Hispanic,66,0,66
"
","
",Black Non-Hispanic,26,0,26
"
","
",Hispanic/Latino,50,0,50
"
","
",Asian Non-Hispanic,7,0,7
"
","
",American Indian/Alaska Native Non-Hispanic,10,0,10
"
","
",Pacific Islander Non-Hispanic,1,0,1
"
","
",Multiracial Non-Hispanic,2,0,2
"
",6 Months to < 1 Year,All Ethnicities,233,2,231
"
","
",White Non-Hispanic,87,0,87
"
","
",Black Non-Hispanic,32,1,31
"
","
",Hispanic/Latino,72,0,72
"
","
",Asian Non-Hispanic,20,0,20
"
","
",American Indian/Alaska Native Non-Hispanic,18,1,17
"
","
",Pacific Islander Non-Hispanic,2,0,2
"
","
",Multiracial Non-Hispanic,2,0,2
"
",1 Year to < 2 Years,All Ethnicities,261,3,258
"
","
","
","
","
","
"
"
","
",White Non-Hispanic,91,0,91
"
","
",Black Non-Hispanic,35,0,35
"
","
",Hispanic/Latino,91,2,89
"
","
",Asian Non-Hispanic,16,0,16
"
","
",American Indian/Alaska Native Non-Hispanic,24,0,24
"
","
",Pacific Islander Non-Hispanic,2,0,2
"
","
",Multiracial Non-Hispanic,2,1,1
"
",2 Years to < 3 Years,All Ethnicities,152,1,151
"
","
",White Non-Hispanic,75,0,75
"
","
",Black Non-Hispanic,12,0,12
"
","
",Hispanic/Latino,34,1,33
"
","
",Asian Non-Hispanic,15,0,15
"
","
",American Indian/Alaska Native Non-Hispanic,13,0,13
"
","
",Pacific Islander Non-Hispanic,2,0,2
"
","
",Multiracial Non-Hispanic,1,0,1
"
",3 Years to < 5 Years,All Ethnicities,140,1,139
"
","
",White Non-Hispanic,58,0,58
"
","
",Black Non-Hispanic,15,0,15
"
","
",Hispanic/Latino,38,1,37
"
","
",Asian Non-Hispanic,12,0,12
"
","
",American Indian/Alaska Native Non-Hispanic,15,0,15
"
","
",Multiracial Non-Hispanic,2,0,2
"
",5 or More Years,All Ethnicities,118,0,118
"
","
",White Non-Hispanic,29,0,29
"
","
",Black Non-Hispanic,11,0,11
"
","
",Hispanic/Latino,50,0,50
"
","
",Asian Non-Hispanic,4,0,4
"
","
",American Indian/Alaska Native Non-Hispanic,24,0,24
CADN-OP1 Donor Network West,All Time,All Ethnicities,7591,158,7433
"
","
",White Non-Hispanic,1543,65,1478
"
","
",Black Non-Hispanic,817,10,807
"
","
",Hispanic/Latino,2993,56,2937
"
","
",Asian Non-Hispanic,1881,14,1867
"
","
",American Indian/Alaska Native Non-Hispanic,35,1,34
"
","
",Pacific Islander Non-Hispanic,206,4,202
"
","
",Multiracial Non-Hispanic,116,8,108
"
",< 30 Days,All Ethnicities,153,6,147
"
","
",White Non-Hispanic,41,2,39
"
","
",Black Non-Hispanic,12,1,11
"
","
",Hispanic/Latino,68,1,67
"
","
",Asian Non-Hispanic,24,1,23
"
","
","
","
","
","
"
"
","
",American Indian/Alaska Native Non-Hispanic,2,0,2
"
","
",Pacific Islander Non-Hispanic,4,0,4
"
","
",Multiracial Non-Hispanic,2,1,1
"
",30 to < 90 Days,All Ethnicities,215,9,206
"
","
",White Non-Hispanic,37,3,34
"
","
",Black Non-Hispanic,24,0,24
"
","
",Hispanic/Latino,89,4,85
"
","
",Asian Non-Hispanic,59,1,58
"
","
",Pacific Islander Non-Hispanic,4,1,3
"
","
",Multiracial Non-Hispanic,2,0,2
"
",90 Days to < 6 Months,All Ethnicities,313,9,304
"
","
",White Non-Hispanic,53,3,50
"
","
",Black Non-Hispanic,39,0,39
"
","
",Hispanic/Latino,140,5,135
"
","
",Asian Non-Hispanic,77,1,76
"
","
",American Indian/Alaska Native Non-Hispanic,1,0,1
"
","
",Pacific Islander Non-Hispanic,1,0,1
"
","
",Multiracial Non-Hispanic,2,0,2
"
",6 Months to < 1 Year,All Ethnicities,595,23,572
"
","
",White Non-Hispanic,120,6,114
"
","
",Black Non-Hispanic,59,1,58
"
","
",Hispanic/Latino,243,10,233
"
","
",Asian Non-Hispanic,135,2,133
"
","
",American Indian/Alaska Native Non-Hispanic,4,0,4
"
","
",Pacific Islander Non-Hispanic,20,1,19
"
","
",Multiracial Non-Hispanic,14,3,11
"
",1 Year to < 2 Years,All Ethnicities,1202,43,1159
"
","
",White Non-Hispanic,290,23,267
"
","
",Black Non-Hispanic,110,5,105
"
","
",Hispanic/Latino,468,11,457
"
","
",Asian Non-Hispanic,280,3,277
"
","
",American Indian/Alaska Native Non-Hispanic,6,0,6
"
","
",Pacific Islander Non-Hispanic,31,1,30
"
","
",Multiracial Non-Hispanic,17,0,17
"
",2 Years to < 3 Years,All Ethnicities,1078,18,1060
"
","
",White Non-Hispanic,232,8,224
"
","
",Black Non-Hispanic,109,1,108
"
","
",Hispanic/Latino,405,5,400
"
","
",Asian Non-Hispanic,273,1,272
"
","
",American Indian/Alaska Native Non-Hispanic,4,0,4
"
","
",Pacific Islander Non-Hispanic,30,0,30
"
","
","
","
","
","
"
"
","
",Multiracial Non-Hispanic,25,3,22
"
",3 Years to < 5 Years,All Ethnicities,1868,25,1843
"
","
",White Non-Hispanic,344,10,334
"
","
",Black Non-Hispanic,186,1,185
"
","
",Hispanic/Latino,749,10,739
"
","
",Asian Non-Hispanic,503,1,502
"
","
",American Indian/Alaska Native Non-Hispanic,8,1,7
"
","
",Pacific Islander Non-Hispanic,48,1,47
"
","
",Multiracial Non-Hispanic,30,1,29
"
",5 or More Years,All Ethnicities,2167,25,2142
"
","
",White Non-Hispanic,426,10,416
"
","
",Black Non-Hispanic,278,1,277
"
","
",Hispanic/Latino,831,10,821
"
","
",Asian Non-Hispanic,530,4,526
"
","
",American Indian/Alaska Native Non-Hispanic,10,0,10
"
","
",Pacific Islander Non-Hispanic,68,0,68
"
","
",Multiracial Non-Hispanic,24,0,24
CAGS-OP1 Sierra Donor Services,All Time,All Ethnicities,1793,13,1780
"
","
",White Non-Hispanic,411,4,407
"
","
",Black Non-Hispanic,221,1,220
"
","
",Hispanic/Latino,538,5,533
"
","
",Asian Non-Hispanic,536,2,534
"
","
",American Indian/Alaska Native Non-Hispanic,7,1,6
"
","
",Pacific Islander Non-Hispanic,37,0,37
"
","
",Multiracial Non-Hispanic,43,0,43
"
",< 30 Days,All Ethnicities,61,0,61
"
","
",White Non-Hispanic,19,0,19
"
","
",Black Non-Hispanic,3,0,3
"
","
",Hispanic/Latino,24,0,24
"
","
",Asian Non-Hispanic,13,0,13
"
","
",Multiracial Non-Hispanic,2,0,2
"
",30 to < 90 Days,All Ethnicities,93,1,92
"
","
",White Non-Hispanic,15,0,15
"
","
",Black Non-Hispanic,10,0,10
"
","
",Hispanic/Latino,44,1,43
"
","
",Asian Non-Hispanic,22,0,22
"
","
",Multiracial Non-Hispanic,2,0,2
"
",90 Days to < 6 Months,All Ethnicities,135,1,134
"
","
",White Non-Hispanic,31,1,30
"
","
",Black Non-Hispanic,20,0,20
"
","
",Hispanic/Latino,32,0,32
"
","
","
","
","
","
"
"
","
",Asian Non-Hispanic,46,0,46
"
","
",Pacific Islander Non-Hispanic,4,0,4
"
","
",Multiracial Non-Hispanic,2,0,2
"
",6 Months to < 1 Year,All Ethnicities,274,1,273
"
","
",White Non-Hispanic,63,0,63
"
","
",Black Non-Hispanic,33,0,33
"
","
",Hispanic/Latino,81,0,81
"
","
",Asian Non-Hispanic,87,1,86
"
","
",Pacific Islander Non-Hispanic,4,0,4
"
","
",Multiracial Non-Hispanic,6,0,6
"
",1 Year to < 2 Years,All Ethnicities,415,4,411
"
","
",White Non-Hispanic,93,2,91
"
","
",Black Non-Hispanic,56,1,55
"
","
",Hispanic/Latino,122,1,121
"
","
",Asian Non-Hispanic,121,0,121
"
","
",American Indian/Alaska Native Non-Hispanic,1,0,1
"
","
",Pacific Islander Non-Hispanic,12,0,12
"
","
",Multiracial Non-Hispanic,10,0,10
"
",2 Years to < 3 Years,All Ethnicities,244,1,243
"
","
",White Non-Hispanic,63,0,63
"
","
",Black Non-Hispanic,31,0,31
"
","
",Hispanic/Latino,66,1,65
"
","
",Asian Non-Hispanic,71,0,71
"
","
",American Indian/Alaska Native Non-Hispanic,2,0,2
"
","
",Pacific Islander Non-Hispanic,6,0,6
"
","
",Multiracial Non-Hispanic,5,0,5
"
",3 Years to < 5 Years,All Ethnicities,373,3,370
"
","
",White Non-Hispanic,75,1,74
"
","
",Black Non-Hispanic,42,0,42
"
","
",Hispanic/Latino,117,0,117
"
","
",Asian Non-Hispanic,120,1,119
"
","
",American Indian/Alaska Native Non-Hispanic,1,1,0
"
","
",Pacific Islander Non-Hispanic,6,0,6
"
","
",Multiracial Non-Hispanic,12,0,12
"
",5 or More Years,All Ethnicities,198,2,196
"
","
",White Non-Hispanic,52,0,52
"
","
",Black Non-Hispanic,26,0,26
"
","
",Hispanic/Latino,52,2,50
"
","
",Asian Non-Hispanic,56,0,56
"
","
",American Indian/Alaska Native Non-Hispanic,3,0,3
"
","
",Pacific Islander Non-Hispanic,5,0,5
"
","
","
","
","
","
"
"
","
",Multiracial Non-Hispanic,4,0,4
CAOP-OP1 OneLegacy,All Time,All Ethnicities,7615,110,7505
"
","
",White Non-Hispanic,1170,28,1142
"
","
",Black Non-Hispanic,747,6,741
"
","
",Hispanic/Latino,4399,63,4336
"
","
",Asian Non-Hispanic,1183,10,1173
"
","
",American Indian/Alaska Native Non-Hispanic,25,0,25
"
","
",Pacific Islander Non-Hispanic,50,3,47
"
","
",Multiracial Non-Hispanic,41,0,41
"
",< 30 Days,All Ethnicities,279,9,270
"
","
",White Non-Hispanic,54,1,53
"
","
",Black Non-Hispanic,23,0,23
"
","
",Hispanic/Latino,164,7,157
"
","
",Asian Non-Hispanic,31,0,31
"
","
",Pacific Islander Non-Hispanic,4,1,3
"
","
",Multiracial Non-Hispanic,3,0,3
"
",30 to < 90 Days,All Ethnicities,449,16,433
"
","
",White Non-Hispanic,76,1,75
"
","
",Black Non-Hispanic,38,1,37
"
","
",Hispanic/Latino,251,13,238
"
","
",Asian Non-Hispanic,76,1,75
"
","
",American Indian/Alaska Native Non-Hispanic,3,0,3
"
","
",Pacific Islander Non-Hispanic,3,0,3
"
","
",Multiracial Non-Hispanic,2,0,2
"
",90 Days to < 6 Months,All Ethnicities,525,7,518
"
","
",White Non-Hispanic,96,2,94
"
","
",Black Non-Hispanic,45,0,45
"
","
",Hispanic/Latino,308,5,303
"
","
",Asian Non-Hispanic,74,0,74
"
","
",Pacific Islander Non-Hispanic,1,0,1
"
","
",Multiracial Non-Hispanic,1,0,1
"
",6 Months to < 1 Year,All Ethnicities,1037,29,1008
"
","
",White Non-Hispanic,195,10,185
"
","
",Black Non-Hispanic,96,2,94
"
","
",Hispanic/Latino,571,13,558
"
","
",Asian Non-Hispanic,160,4,156
"
","
",American Indian/Alaska Native Non-Hispanic,7,0,7
"
","
",Pacific Islander Non-Hispanic,5,0,5
"
","
",Multiracial Non-Hispanic,3,0,3
"
",1 Year to < 2 Years,All Ethnicities,1414,16,1398
"
","
",White Non-Hispanic,232,3,229
"
","
","
","
","
","
"
"
","
",Black Non-Hispanic,138,1,137
"
","
",Hispanic/Latino,781,9,772
"
","
",Asian Non-Hispanic,241,2,239
"
","
",American Indian/Alaska Native Non-Hispanic,3,0,3
"
","
",Pacific Islander Non-Hispanic,8,1,7
"
","
",Multiracial Non-Hispanic,11,0,11
"
",2 Years to < 3 Years,All Ethnicities,1031,13,1018
"
","
",White Non-Hispanic,157,3,154
"
","
",Black Non-Hispanic,104,2,102
"
","
",Hispanic/Latino,595,7,588
"
","
",Asian Non-Hispanic,160,1,159
"
","
",American Indian/Alaska Native Non-Hispanic,3,0,3
"
","
",Pacific Islander Non-Hispanic,5,0,5
"
","
",Multiracial Non-Hispanic,7,0,7
"
",3 Years to < 5 Years,All Ethnicities,1530,13,1517
"
","
",White Non-Hispanic,201,6,195
"
","
",Black Non-Hispanic,150,0,150
"
","
",Hispanic/Latino,904,5,899
"
","
",Asian Non-Hispanic,250,2,248
"
","
",American Indian/Alaska Native Non-Hispanic,7,0,7
"
","
",Pacific Islander Non-Hispanic,11,0,11
"
","
",Multiracial Non-Hispanic,7,0,7
"
",5 or More Years,All Ethnicities,1350,7,1343
"
","
",White Non-Hispanic,159,2,157
"
","
",Black Non-Hispanic,153,0,153
"
","
",Hispanic/Latino,825,4,821
"
","
",Asian Non-Hispanic,191,0,191
"
","
",American Indian/Alaska Native Non-Hispanic,2,0,2
"
","
",Pacific Islander Non-Hispanic,13,1,12
"
","
",Multiracial Non-Hispanic,7,0,7
CASD-IO1 Lifesharing - A Donate Life Organization,All Time,All Ethnicities,1606,11,1595
"
","
",White Non-Hispanic,386,5,381
"
","
",Black Non-Hispanic,152,2,150
"
","
",Hispanic/Latino,708,3,705
"
","
",Asian Non-Hispanic,313,0,313
"
","
",American Indian/Alaska Native Non-Hispanic,10,0,10
"
","
",Pacific Islander Non-Hispanic,20,1,19
"
","
",Multiracial Non-Hispanic,17,0,17
"
",< 30 Days,All Ethnicities,47,0,47
"
","
",White Non-Hispanic,13,0,13
"
","
",Black Non-Hispanic,4,0,4
"
","
","
","
","
","
"
"
","
",Hispanic/Latino,20,0,20
"
","
",Asian Non-Hispanic,9,0,9
"
","
",Multiracial Non-Hispanic,1,0,1
"
",30 to < 90 Days,All Ethnicities,75,1,74
"
","
",White Non-Hispanic,30,1,29
"
","
",Black Non-Hispanic,4,0,4
"
","
",Hispanic/Latino,25,0,25
"
","
",Asian Non-Hispanic,14,0,14
"
","
",Multiracial Non-Hispanic,2,0,2
"
",90 Days to < 6 Months,All Ethnicities,86,1,85
"
","
",White Non-Hispanic,19,0,19
"
","
",Black Non-Hispanic,11,0,11
"
","
",Hispanic/Latino,30,0,30
"
","
",Asian Non-Hispanic,23,0,23
"
","
",Pacific Islander Non-Hispanic,2,1,1
"
","
",Multiracial Non-Hispanic,1,0,1
"
",6 Months to < 1 Year,All Ethnicities,221,3,218
"
","
",White Non-Hispanic,52,2,50
"
","
",Black Non-Hispanic,19,0,19
"
","
",Hispanic/Latino,91,1,90
"
","
",Asian Non-Hispanic,52,0,52
"
","
",Pacific Islander Non-Hispanic,5,0,5
"
","
",Multiracial Non-Hispanic,2,0,2
"
",1 Year to < 2 Years,All Ethnicities,299,4,295
"
","
",White Non-Hispanic,79,2,77
"
","
",Black Non-Hispanic,29,1,28
"
","
",Hispanic/Latino,123,1,122
"
","
",Asian Non-Hispanic,59,0,59
"
","
",American Indian/Alaska Native Non-Hispanic,2,0,2
"
","
",Pacific Islander Non-Hispanic,3,0,3
"
","
",Multiracial Non-Hispanic,4,0,4
"
",2 Years to < 3 Years,All Ethnicities,288,0,288
"
","
",White Non-Hispanic,51,0,51
"
","
",Black Non-Hispanic,28,0,28
"
","
",Hispanic/Latino,135,0,135
"
","
",Asian Non-Hispanic,61,0,61
"
","
",American Indian/Alaska Native Non-Hispanic,4,0,4
"
","
",Pacific Islander Non-Hispanic,7,0,7
"
","
",Multiracial Non-Hispanic,2,0,2
"
",3 Years to < 5 Years,All Ethnicities,326,1,325
"
","
",White Non-Hispanic,73,0,73
"
","
","
","
","
","
"
"
","
",Black Non-Hispanic,30,0,30
"
","
",Hispanic/Latino,161,1,160
"
","
",Asian Non-Hispanic,56,0,56
"
","
",American Indian/Alaska Native Non-Hispanic,2,0,2
"
","
",Pacific Islander Non-Hispanic,2,0,2
"
","
",Multiracial Non-Hispanic,2,0,2
"
",5 or More Years,All Ethnicities,264,1,263
"
","
",White Non-Hispanic,69,0,69
"
","
",Black Non-Hispanic,27,1,26
"
","
",Hispanic/Latino,123,0,123
"
","
",Asian Non-Hispanic,39,0,39
"
","
",American Indian/Alaska Native Non-Hispanic,2,0,2
"
","
",Pacific Islander Non-Hispanic,1,0,1
"
","
",Multiracial Non-Hispanic,3,0,3
CORS-OP1 Donor Alliance,All Time,All Ethnicities,1081,25,1056
"
","
",White Non-Hispanic,608,13,595
"
","
",Black Non-Hispanic,121,3,118
"
","
",Hispanic/Latino,271,7,264
"
","
",Asian Non-Hispanic,51,2,49
"
","
",American Indian/Alaska Native Non-Hispanic,19,0,19
"
","
",Pacific Islander Non-Hispanic,4,0,4
"
","
",Multiracial Non-Hispanic,7,0,7
"
",< 30 Days,All Ethnicities,50,0,50
"
","
",White Non-Hispanic,39,0,39
"
","
",Black Non-Hispanic,1,0,1
"
","
",Hispanic/Latino,8,0,8
"
","
",Asian Non-Hispanic,1,0,1
"
","
",American Indian/Alaska Native Non-Hispanic,1,0,1
"
",30 to < 90 Days,All Ethnicities,92,3,89
"
","
",White Non-Hispanic,57,2,55
"
","
",Black Non-Hispanic,6,0,6
"
","
",Hispanic/Latino,24,1,23
"
","
",Asian Non-Hispanic,4,0,4
"
","
",American Indian/Alaska Native Non-Hispanic,1,0,1
"
",90 Days to < 6 Months,All Ethnicities,91,7,84
"
","
",White Non-Hispanic,52,5,47
"
","
",Black Non-Hispanic,7,1,6
"
","
",Hispanic/Latino,27,1,26
"
","
",Asian Non-Hispanic,2,0,2
"
","
",American Indian/Alaska Native Non-Hispanic,2,0,2
"
","
",Multiracial Non-Hispanic,1,0,1
"
","
","
","
","
","
"
"
",6 Months to < 1 Year,All Ethnicities,193,8,185
"
","
",White Non-Hispanic,110,3,107
"
","
",Black Non-Hispanic,18,1,17
"
","
",Hispanic/Latino,51,3,48
"
","
",Asian Non-Hispanic,10,1,9
"
","
",American Indian/Alaska Native Non-Hispanic,1,0,1
"
","
",Pacific Islander Non-Hispanic,2,0,2
"
","
",Multiracial Non-Hispanic,1,0,1
"
",1 Year to < 2 Years,All Ethnicities,277,5,272
"
","
",White Non-Hispanic,148,2,146
"
","
",Black Non-Hispanic,33,0,33
"
","
",Hispanic/Latino,72,2,70
"
","
",Asian Non-Hispanic,12,1,11
"
","
",American Indian/Alaska Native Non-Hispanic,9,0,9
"
","
",Pacific Islander Non-Hispanic,2,0,2
"
","
",Multiracial Non-Hispanic,1,0,1
"
",2 Years to < 3 Years,All Ethnicities,140,2,138
"
","
",White Non-Hispanic,78,1,77
"
","
",Black Non-Hispanic,25,1,24
"
","
",Hispanic/Latino,26,0,26
"
","
",Asian Non-Hispanic,9,0,9
"
","
",American Indian/Alaska Native Non-Hispanic,1,0,1
"
","
",Multiracial Non-Hispanic,1,0,1
"
",3 Years to < 5 Years,All Ethnicities,158,0,158
"
","
",White Non-Hispanic,80,0,80
"
","
",Black Non-Hispanic,23,0,23
"
","
",Hispanic/Latino,41,0,41
"
","
",Asian Non-Hispanic,9,0,9
"
","
",American Indian/Alaska Native Non-Hispanic,4,0,4
"
","
",Multiracial Non-Hispanic,1,0,1
"
",5 or More Years,All Ethnicities,80,0,80
"
","
",White Non-Hispanic,44,0,44
"
","
",Black Non-Hispanic,8,0,8
"
","
",Hispanic/Latino,22,0,22
"
","
",Asian Non-Hispanic,4,0,4
"
","
",Multiracial Non-Hispanic,2,0,2
FLFH-IO1 OurLegacy,All Time,All Ethnicities,561,3,558
"
","
",White Non-Hispanic,237,0,237
"
","
",Black Non-Hispanic,176,1,175
"
","
",Hispanic/Latino,105,2,103
"
","
",Asian Non-Hispanic,35,0,35
"
","
","
","
","
","
"
"
","
",Pacific Islander Non-Hispanic,4,0,4
"
","
",Multiracial Non-Hispanic,4,0,4
"
",< 30 Days,All Ethnicities,35,0,35
"
","
",White Non-Hispanic,9,0,9
"
","
",Black Non-Hispanic,16,0,16
"
","
",Hispanic/Latino,7,0,7
"
","
",Asian Non-Hispanic,2,0,2
"
","
",Multiracial Non-Hispanic,1,0,1
"
",30 to < 90 Days,All Ethnicities,43,0,43
"
","
",White Non-Hispanic,19,0,19
"
","
",Black Non-Hispanic,6,0,6
"
","
",Hispanic/Latino,13,0,13
"
","
",Asian Non-Hispanic,3,0,3
"
","
",Pacific Islander Non-Hispanic,2,0,2
"
",90 Days to < 6 Months,All Ethnicities,47,0,47
"
","
",White Non-Hispanic,15,0,15
"
","
",Black Non-Hispanic,19,0,19
"
","
",Hispanic/Latino,11,0,11
"
","
",Asian Non-Hispanic,2,0,2
"
",6 Months to < 1 Year,All Ethnicities,96,1,95
"
","
",White Non-Hispanic,47,0,47
"
","
",Black Non-Hispanic,26,0,26
"
","
",Hispanic/Latino,20,1,19
"
","
",Asian Non-Hispanic,3,0,3
"
",1 Year to < 2 Years,All Ethnicities,125,2,123
"
","
",White Non-Hispanic,54,0,54
"
","
",Black Non-Hispanic,39,1,38
"
","
",Hispanic/Latino,17,1,16
"
","
",Asian Non-Hispanic,14,0,14
"
","
",Pacific Islander Non-Hispanic,1,0,1
"
",2 Years to < 3 Years,All Ethnicities,78,0,78
"
","
",White Non-Hispanic,36,0,36
"
","
",Black Non-Hispanic,24,0,24
"
","
",Hispanic/Latino,12,0,12
"
","
",Asian Non-Hispanic,5,0,5
"
","
",Pacific Islander Non-Hispanic,1,0,1
"
",3 Years to < 5 Years,All Ethnicities,84,0,84
"
","
",White Non-Hispanic,33,0,33
"
","
",Black Non-Hispanic,24,0,24
"
","
",Hispanic/Latino,20,0,20
"
","
",Asian Non-Hispanic,5,0,5
"
","
","
","
","
","
"
"
","
",Multiracial Non-Hispanic,2,0,2
"
",5 or More Years,All Ethnicities,53,0,53
"
","
",White Non-Hispanic,24,0,24
"
","
",Black Non-Hispanic,22,0,22
"
","
",Hispanic/Latino,5,0,5
"
","
",Asian Non-Hispanic,1,0,1
"
","
",Multiracial Non-Hispanic,1,0,1
FLMP-OP1 Life Alliance Organ Recovery Agency,All Time,All Ethnicities,1577,16,1561
"
","
",White Non-Hispanic,353,2,351
"
","
",Black Non-Hispanic,692,6,686
"
","
",Hispanic/Latino,446,6,440
"
","
",Asian Non-Hispanic,70,1,69
"
","
",American Indian/Alaska Native Non-Hispanic,5,1,4
"
","
",Pacific Islander Non-Hispanic,1,0,1
"
","
",Multiracial Non-Hispanic,10,0,10
"
",< 30 Days,All Ethnicities,109,3,106
"
","
",White Non-Hispanic,28,0,28
"
","
",Black Non-Hispanic,36,1,35
"
","
",Hispanic/Latino,38,1,37
"
","
",Asian Non-Hispanic,6,0,6
"
","
",American Indian/Alaska Native Non-Hispanic,1,1,0
"
",30 to < 90 Days,All Ethnicities,147,4,143
"
","
",White Non-Hispanic,28,0,28
"
","
",Black Non-Hispanic,54,1,53
"
","
",Hispanic/Latino,56,3,53
"
","
",Asian Non-Hispanic,9,0,9
"
",90 Days to < 6 Months,All Ethnicities,180,0,180
"
","
",White Non-Hispanic,41,0,41
"
","
",Black Non-Hispanic,84,0,84
"
","
",Hispanic/Latino,46,0,46
"
","
",Asian Non-Hispanic,6,0,6
"
","
",American Indian/Alaska Native Non-Hispanic,1,0,1
"
","
",Multiracial Non-Hispanic,2,0,2
"
",6 Months to < 1 Year,All Ethnicities,280,4,276
"
","
",White Non-Hispanic,63,1,62
"
","
",Black Non-Hispanic,115,2,113
"
","
",Hispanic/Latino,89,1,88
"
","
",Asian Non-Hispanic,9,0,9
"
","
",American Indian/Alaska Native Non-Hispanic,1,0,1
"
","
",Multiracial Non-Hispanic,3,0,3
"
",1 Year to < 2 Years,All Ethnicities,330,3,327
"
","
","
","
","
","
"
"
","
",White Non-Hispanic,81,1,80
"
","
",Black Non-Hispanic,147,0,147
"
","
",Hispanic/Latino,84,1,83
"
","
",Asian Non-Hispanic,17,1,16
"
","
",Multiracial Non-Hispanic,1,0,1
"
",2 Years to < 3 Years,All Ethnicities,187,1,186
"
","
",White Non-Hispanic,50,0,50
"
","
",Black Non-Hispanic,86,1,85
"
","
",Hispanic/Latino,42,0,42
"
","
",Asian Non-Hispanic,7,0,7
"
","
",Pacific Islander Non-Hispanic,1,0,1
"
","
",Multiracial Non-Hispanic,1,0,1
"
",3 Years to < 5 Years,All Ethnicities,251,1,250
"
","
",White Non-Hispanic,48,0,48
"
","
",Black Non-Hispanic,121,1,120
"
","
",Hispanic/Latino,64,0,64
"
","
",Asian Non-Hispanic,13,0,13
"
","
",American Indian/Alaska Native Non-Hispanic,2,0,2
"
","
",Multiracial Non-Hispanic,3,0,3
"
",5 or More Years,All Ethnicities,93,0,93
"
","
",White Non-Hispanic,14,0,14
"
","
",Black Non-Hispanic,49,0,49
"
","
",Hispanic/Latino,27,0,27
"
","
",Asian Non-Hispanic,3,0,3
FLUF-IO1 LifeQuest Organ Recovery Services,All Time,All Ethnicities,1396,9,1387
"
","
",White Non-Hispanic,593,4,589
"
","
",Black Non-Hispanic,629,3,626
"
","
",Hispanic/Latino,79,2,77
"
","
",Asian Non-Hispanic,77,0,77
"
","
",American Indian/Alaska Native Non-Hispanic,5,0,5
"
","
",Pacific Islander Non-Hispanic,2,0,2
"
","
",Multiracial Non-Hispanic,11,0,11
"
",< 30 Days,All Ethnicities,65,1,64
"
","
",White Non-Hispanic,26,0,26
"
","
",Black Non-Hispanic,30,0,30
"
","
",Hispanic/Latino,3,1,2
"
","
",Asian Non-Hispanic,5,0,5
"
","
",Multiracial Non-Hispanic,1,0,1
"
",30 to < 90 Days,All Ethnicities,118,0,118
"
","
",White Non-Hispanic,48,0,48
"
","
",Black Non-Hispanic,54,0,54
"
","
","
","
","
","
"
"
","
",Hispanic/Latino,10,0,10
"
","
",Asian Non-Hispanic,4,0,4
"
","
",Pacific Islander Non-Hispanic,1,0,1
"
","
",Multiracial Non-Hispanic,1,0,1
"
",90 Days to < 6 Months,All Ethnicities,167,1,166
"
","
",White Non-Hispanic,77,1,76
"
","
",Black Non-Hispanic,70,0,70
"
","
",Hispanic/Latino,10,0,10
"
","
",Asian Non-Hispanic,10,0,10
"
",6 Months to < 1 Year,All Ethnicities,292,1,291
"
","
",White Non-Hispanic,131,0,131
"
","
",Black Non-Hispanic,123,1,122
"
","
",Hispanic/Latino,15,0,15
"
","
",Asian Non-Hispanic,20,0,20
"
","
",American Indian/Alaska Native Non-Hispanic,1,0,1
"
","
",Multiracial Non-Hispanic,2,0,2
"
",1 Year to < 2 Years,All Ethnicities,298,2,296
"
","
",White Non-Hispanic,135,1,134
"
","
",Black Non-Hispanic,123,1,122
"
","
",Hispanic/Latino,18,0,18
"
","
",Asian Non-Hispanic,16,0,16
"
","
",American Indian/Alaska Native Non-Hispanic,2,0,2
"
","
",Multiracial Non-Hispanic,4,0,4
"
",2 Years to < 3 Years,All Ethnicities,169,4,165
"
","
",White Non-Hispanic,77,2,75
"
","
",Black Non-Hispanic,74,1,73
"
","
",Hispanic/Latino,8,1,7
"
","
",Asian Non-Hispanic,5,0,5
"
","
",American Indian/Alaska Native Non-Hispanic,1,0,1
"
","
",Pacific Islander Non-Hispanic,1,0,1
"
","
",Multiracial Non-Hispanic,3,0,3
"
",3 Years to < 5 Years,All Ethnicities,186,0,186
"
","
",White Non-Hispanic,64,0,64
"
","
",Black Non-Hispanic,99,0,99
"
","
",Hispanic/Latino,11,0,11
"
","
",Asian Non-Hispanic,12,0,12
"
",5 or More Years,All Ethnicities,101,0,101
"
","
",White Non-Hispanic,35,0,35
"
","
",Black Non-Hispanic,56,0,56
"
","
",Hispanic/Latino,4,0,4
"
","
",Asian Non-Hispanic,5,0,5
"
","
","
","
","
","
"
"
","
",American Indian/Alaska Native Non-Hispanic,1,0,1
FLWC-OP1 LifeLink of Florida,All Time,All Ethnicities,1077,11,1066
"
","
",White Non-Hispanic,507,5,502
"
","
",Black Non-Hispanic,291,2,289
"
","
",Hispanic/Latino,202,3,199
"
","
",Asian Non-Hispanic,69,1,68
"
","
",American Indian/Alaska Native Non-Hispanic,2,0,2
"
","
",Pacific Islander Non-Hispanic,1,0,1
"
","
",Multiracial Non-Hispanic,5,0,5
"
",< 30 Days,All Ethnicities,95,2,93
"
","
",White Non-Hispanic,45,2,43
"
","
",Black Non-Hispanic,21,0,21
"
","
",Hispanic/Latino,20,0,20
"
","
",Asian Non-Hispanic,7,0,7
"
","
",Multiracial Non-Hispanic,2,0,2
"
",30 to < 90 Days,All Ethnicities,146,3,143
"
","
",White Non-Hispanic,83,2,81
"
","
",Black Non-Hispanic,30,1,29
"
","
",Hispanic/Latino,29,0,29
"
","
",Asian Non-Hispanic,4,0,4
"
",90 Days to < 6 Months,All Ethnicities,154,1,153
"
","
",White Non-Hispanic,76,1,75
"
","
",Black Non-Hispanic,42,0,42
"
","
",Hispanic/Latino,21,0,21
"
","
",Asian Non-Hispanic,12,0,12
"
","
",American Indian/Alaska Native Non-Hispanic,1,0,1
"
","
",Pacific Islander Non-Hispanic,1,0,1
"
","
",Multiracial Non-Hispanic,1,0,1
"
",6 Months to < 1 Year,All Ethnicities,203,1,202
"
","
",White Non-Hispanic,97,0,97
"
","
",Black Non-Hispanic,53,0,53
"
","
",Hispanic/Latino,36,1,35
"
","
",Asian Non-Hispanic,16,0,16
"
","
",American Indian/Alaska Native Non-Hispanic,1,0,1
"
",1 Year to < 2 Years,All Ethnicities,200,0,200
"
","
",White Non-Hispanic,94,0,94
"
","
",Black Non-Hispanic,49,0,49
"
","
",Hispanic/Latino,46,0,46
"
","
",Asian Non-Hispanic,11,0,11
"
",2 Years to < 3 Years,All Ethnicities,102,1,101
"
","
",White Non-Hispanic,41,0,41
"
","
","
","
","
","
"
"
","
",Black Non-Hispanic,37,0,37
"
","
",Hispanic/Latino,16,1,15
"
","
",Asian Non-Hispanic,8,0,8
"
",3 Years to < 5 Years,All Ethnicities,132,3,129
"
","
",White Non-Hispanic,54,0,54
"
","
",Black Non-Hispanic,40,1,39
"
","
",Hispanic/Latino,28,1,27
"
","
",Asian Non-Hispanic,9,1,8
"
","
",Multiracial Non-Hispanic,1,0,1
"
",5 or More Years,All Ethnicities,45,0,45
"
","
",White Non-Hispanic,17,0,17
"
","
",Black Non-Hispanic,19,0,19
"
","
",Hispanic/Latino,6,0,6
"
","
",Asian Non-Hispanic,2,0,2
"
","
",Multiracial Non-Hispanic,1,0,1
GALL-OP1 LifeLink of Georgia,All Time,All Ethnicities,2700,38,2662
"
","
",White Non-Hispanic,577,11,566
"
","
",Black Non-Hispanic,1866,18,1848
"
","
",Hispanic/Latino,136,7,129
"
","
",Asian Non-Hispanic,114,1,113
"
","
",American Indian/Alaska Native Non-Hispanic,2,1,1
"
","
",Pacific Islander Non-Hispanic,3,0,3
"
","
",Multiracial Non-Hispanic,2,0,2
"
",< 30 Days,All Ethnicities,97,4,93
"
","
",White Non-Hispanic,27,3,24
"
","
",Black Non-Hispanic,62,1,61
"
","
",Hispanic/Latino,5,0,5
"
","
",Asian Non-Hispanic,3,0,3
"
",30 to < 90 Days,All Ethnicities,179,3,176
"
","
",White Non-Hispanic,50,0,50
"
","
",Black Non-Hispanic,112,1,111
"
","
",Hispanic/Latino,6,2,4
"
","
",Asian Non-Hispanic,11,0,11
"
",90 Days to < 6 Months,All Ethnicities,203,8,195
"
","
",White Non-Hispanic,51,2,49
"
","
",Black Non-Hispanic,127,3,124
"
","
",Hispanic/Latino,11,2,9
"
","
",Asian Non-Hispanic,13,0,13
"
","
",American Indian/Alaska Native Non-Hispanic,1,1,0
"
",6 Months to < 1 Year,All Ethnicities,396,8,388
"
","
",White Non-Hispanic,82,3,79
"
","
","
","
","
","
"
"
","
",Black Non-Hispanic,273,3,270
"
","
",Hispanic/Latino,25,1,24
"
","
",Asian Non-Hispanic,14,1,13
"
","
",Multiracial Non-Hispanic,2,0,2
"
",1 Year to < 2 Years,All Ethnicities,686,7,679
"
","
",White Non-Hispanic,152,2,150
"
","
",Black Non-Hispanic,468,3,465
"
","
",Hispanic/Latino,32,2,30
"
","
",Asian Non-Hispanic,32,0,32
"
","
",Pacific Islander Non-Hispanic,2,0,2
"
",2 Years to < 3 Years,All Ethnicities,322,3,319
"
","
",White Non-Hispanic,73,0,73
"
","
",Black Non-Hispanic,221,3,218
"
","
",Hispanic/Latino,12,0,12
"
","
",Asian Non-Hispanic,16,0,16
"
",3 Years to < 5 Years,All Ethnicities,476,0,476
"
","
",White Non-Hispanic,91,0,91
"
","
",Black Non-Hispanic,339,0,339
"
","
",Hispanic/Latino,32,0,32
"
","
",Asian Non-Hispanic,14,0,14
"
",5 or More Years,All Ethnicities,341,5,336
"
","
",White Non-Hispanic,51,1,50
"
","
",Black Non-Hispanic,264,4,260
"
","
",Hispanic/Latino,13,0,13
"
","
",Asian Non-Hispanic,11,0,11
"
","
",American Indian/Alaska Native Non-Hispanic,1,0,1
"
","
",Pacific Islander Non-Hispanic,1,0,1
HIOP-OP1 Legacy of Life Hawaii,All Time,All Ethnicities,307,0,307
"
","
",White Non-Hispanic,17,0,17
"
","
",Black Non-Hispanic,2,0,2
"
","
",Hispanic/Latino,9,0,9
"
","
",Asian Non-Hispanic,202,0,202
"
","
",Pacific Islander Non-Hispanic,29,0,29
"
","
",Multiracial Non-Hispanic,48,0,48
"
",< 30 Days,All Ethnicities,12,0,12
"
","
",Hispanic/Latino,1,0,1
"
","
",Asian Non-Hispanic,8,0,8
"
","
",Multiracial Non-Hispanic,3,0,3
"
",30 to < 90 Days,All Ethnicities,19,0,19
"
","
",White Non-Hispanic,2,0,2
"
","
",Black Non-Hispanic,1,0,1
"
","
","
","
","
","
"
"
","
",Asian Non-Hispanic,12,0,12
"
","
",Pacific Islander Non-Hispanic,3,0,3
"
","
",Multiracial Non-Hispanic,1,0,1
"
",90 Days to < 6 Months,All Ethnicities,14,0,14
"
","
",White Non-Hispanic,1,0,1
"
","
",Black Non-Hispanic,1,0,1
"
","
",Asian Non-Hispanic,8,0,8
"
","
",Pacific Islander Non-Hispanic,1,0,1
"
","
",Multiracial Non-Hispanic,3,0,3
"
",6 Months to < 1 Year,All Ethnicities,32,0,32
"
","
",White Non-Hispanic,2,0,2
"
","
",Asian Non-Hispanic,20,0,20
"
","
",Pacific Islander Non-Hispanic,3,0,3
"
","
",Multiracial Non-Hispanic,7,0,7
"
",1 Year to < 2 Years,All Ethnicities,53,0,53
"
","
",White Non-Hispanic,6,0,6
"
","
",Hispanic/Latino,2,0,2
"
","
",Asian Non-Hispanic,32,0,32
"
","
",Pacific Islander Non-Hispanic,6,0,6
"
","
",Multiracial Non-Hispanic,7,0,7
"
",2 Years to < 3 Years,All Ethnicities,66,0,66
"
","
",White Non-Hispanic,5,0,5
"
","
",Hispanic/Latino,1,0,1
"
","
",Asian Non-Hispanic,46,0,46
"
","
",Pacific Islander Non-Hispanic,5,0,5
"
","
",Multiracial Non-Hispanic,9,0,9
"
",3 Years to < 5 Years,All Ethnicities,59,0,59
"
","
",White Non-Hispanic,1,0,1
"
","
",Hispanic/Latino,1,0,1
"
","
",Asian Non-Hispanic,37,0,37
"
","
",Pacific Islander Non-Hispanic,9,0,9
"
","
",Multiracial Non-Hispanic,11,0,11
"
",5 or More Years,All Ethnicities,52,0,52
"
","
",Hispanic/Latino,4,0,4
"
","
",Asian Non-Hispanic,39,0,39
"
","
",Pacific Islander Non-Hispanic,2,0,2
"
","
",Multiracial Non-Hispanic,7,0,7
IAOP-OP1 Iowa Donor Network,All Time,All Ethnicities,590,6,584
"
","
",White Non-Hispanic,399,1,398
"
","
",Black Non-Hispanic,95,2,93
"
","
",Hispanic/Latino,57,0,57
"
","
","
","
","
","
"
"
","
",Asian Non-Hispanic,26,2,24
"
","
",American Indian/Alaska Native Non-Hispanic,9,0,9
"
","
",Pacific Islander Non-Hispanic,3,0,3
"
","
",Multiracial Non-Hispanic,1,1,0
"
",< 30 Days,All Ethnicities,30,0,30
"
","
",White Non-Hispanic,17,0,17
"
","
",Black Non-Hispanic,6,0,6
"
","
",Hispanic/Latino,3,0,3
"
","
",Asian Non-Hispanic,4,0,4
"
",30 to < 90 Days,All Ethnicities,67,1,66
"
","
",White Non-Hispanic,43,1,42
"
","
",Black Non-Hispanic,9,0,9
"
","
",Hispanic/Latino,7,0,7
"
","
",Asian Non-Hispanic,4,0,4
"
","
",American Indian/Alaska Native Non-Hispanic,3,0,3
"
","
",Pacific Islander Non-Hispanic,1,0,1
"
",90 Days to < 6 Months,All Ethnicities,83,1,82
"
","
",White Non-Hispanic,55,0,55
"
","
",Black Non-Hispanic,11,0,11
"
","
",Hispanic/Latino,11,0,11
"
","
",Asian Non-Hispanic,4,0,4
"
","
",American Indian/Alaska Native Non-Hispanic,1,0,1
"
","
",Multiracial Non-Hispanic,1,1,0
"
",6 Months to < 1 Year,All Ethnicities,106,3,103
"
","
",White Non-Hispanic,78,0,78
"
","
",Black Non-Hispanic,14,1,13
"
","
",Hispanic/Latino,8,0,8
"
","
",Asian Non-Hispanic,4,2,2
"
","
",American Indian/Alaska Native Non-Hispanic,1,0,1
"
","
",Pacific Islander Non-Hispanic,1,0,1
"
",1 Year to < 2 Years,All Ethnicities,131,1,130
"
","
",White Non-Hispanic,95,0,95
"
","
",Black Non-Hispanic,26,1,25
"
","
",Hispanic/Latino,8,0,8
"
","
",Asian Non-Hispanic,2,0,2
"
",2 Years to < 3 Years,All Ethnicities,77,0,77
"
","
",White Non-Hispanic,50,0,50
"
","
",Black Non-Hispanic,11,0,11
"
","
",Hispanic/Latino,9,0,9
"
","
",Asian Non-Hispanic,4,0,4
"
","
",American Indian/Alaska Native Non-Hispanic,2,0,2
"
","
","
","
","
","
"
"
","
",Pacific Islander Non-Hispanic,1,0,1
"
",3 Years to < 5 Years,All Ethnicities,69,0,69
"
","
",White Non-Hispanic,46,0,46
"
","
",Black Non-Hispanic,12,0,12
"
","
",Hispanic/Latino,5,0,5
"
","
",Asian Non-Hispanic,4,0,4
"
","
",American Indian/Alaska Native Non-Hispanic,2,0,2
"
",5 or More Years,All Ethnicities,27,0,27
"
","
",White Non-Hispanic,15,0,15
"
","
",Black Non-Hispanic,6,0,6
"
","
",Hispanic/Latino,6,0,6
ILIP-OP1 Gift of Hope Organ & Tissue Donor Network,All Time,All Ethnicities,3336,43,3293
"
","
",White Non-Hispanic,1060,16,1044
"
","
",Black Non-Hispanic,1317,8,1309
"
","
",Hispanic/Latino,733,16,717
"
","
",Asian Non-Hispanic,193,2,191
"
","
",American Indian/Alaska Native Non-Hispanic,7,0,7
"
","
",Pacific Islander Non-Hispanic,6,0,6
"
","
",Multiracial Non-Hispanic,20,1,19
"
",< 30 Days,All Ethnicities,163,5,158
"
","
",White Non-Hispanic,61,2,59
"
","
",Black Non-Hispanic,51,0,51
"
","
",Hispanic/Latino,41,3,38
"
","
",Asian Non-Hispanic,10,0,10
"
",30 to < 90 Days,All Ethnicities,284,6,278
"
","
",White Non-Hispanic,93,2,91
"
","
",Black Non-Hispanic,108,0,108
"
","
",Hispanic/Latino,66,4,62
"
","
",Asian Non-Hispanic,16,0,16
"
","
",American Indian/Alaska Native Non-Hispanic,1,0,1
"
",90 Days to < 6 Months,All Ethnicities,312,4,308
"
","
",White Non-Hispanic,94,2,92
"
","
",Black Non-Hispanic,111,0,111
"
","
",Hispanic/Latino,84,2,82
"
","
",Asian Non-Hispanic,19,0,19
"
","
",American Indian/Alaska Native Non-Hispanic,2,0,2
"
","
",Pacific Islander Non-Hispanic,2,0,2
"
",6 Months to < 1 Year,All Ethnicities,519,8,511
"
","
",White Non-Hispanic,171,2,169
"
","
",Black Non-Hispanic,197,3,194
"
","
",Hispanic/Latino,110,2,108
"
","
","
","
","
","
"
"
","
",Asian Non-Hispanic,34,0,34
"
","
",American Indian/Alaska Native Non-Hispanic,2,0,2
"
","
",Multiracial Non-Hispanic,5,1,4
"
",1 Year to < 2 Years,All Ethnicities,824,9,815
"
","
",White Non-Hispanic,259,3,256
"
","
",Black Non-Hispanic,295,4,291
"
","
",Hispanic/Latino,217,1,216
"
","
",Asian Non-Hispanic,46,1,45
"
","
",American Indian/Alaska Native Non-Hispanic,1,0,1
"
","
",Pacific Islander Non-Hispanic,2,0,2
"
","
",Multiracial Non-Hispanic,4,0,4
"
",2 Years to < 3 Years,All Ethnicities,452,3,449
"
","
",White Non-Hispanic,148,1,147
"
","
",Black Non-Hispanic,188,0,188
"
","
",Hispanic/Latino,91,1,90
"
","
",Asian Non-Hispanic,21,1,20
"
","
",Multiracial Non-Hispanic,4,0,4
"
",3 Years to < 5 Years,All Ethnicities,473,3,470
"
","
",White Non-Hispanic,151,1,150
"
","
",Black Non-Hispanic,204,0,204
"
","
",Hispanic/Latino,85,2,83
"
","
",Asian Non-Hispanic,28,0,28
"
","
",American Indian/Alaska Native Non-Hispanic,1,0,1
"
","
",Pacific Islander Non-Hispanic,1,0,1
"
","
",Multiracial Non-Hispanic,3,0,3
"
",5 or More Years,All Ethnicities,309,5,304
"
","
",White Non-Hispanic,83,3,80
"
","
",Black Non-Hispanic,163,1,162
"
","
",Hispanic/Latino,39,1,38
"
","
",Asian Non-Hispanic,19,0,19
"
","
",Pacific Islander Non-Hispanic,1,0,1
"
","
",Multiracial Non-Hispanic,4,0,4
INOP-OP1 Indiana Donor Network,All Time,All Ethnicities,1026,4,1022
"
","
",White Non-Hispanic,582,4,578
"
","
",Black Non-Hispanic,325,0,325
"
","
",Hispanic/Latino,68,0,68
"
","
",Asian Non-Hispanic,44,0,44
"
","
",American Indian/Alaska Native Non-Hispanic,3,0,3
"
","
",Pacific Islander Non-Hispanic,2,0,2
"
","
",Multiracial Non-Hispanic,2,0,2
"
",< 30 Days,All Ethnicities,56,0,56
"
","
","
","
","
","
"
"
","
",White Non-Hispanic,34,0,34
"
","
",Black Non-Hispanic,16,0,16
"
","
",Hispanic/Latino,4,0,4
"
","
",Asian Non-Hispanic,2,0,2
"
",30 to < 90 Days,All Ethnicities,102,3,99
"
","
",White Non-Hispanic,59,3,56
"
","
",Black Non-Hispanic,35,0,35
"
","
",Hispanic/Latino,5,0,5
"
","
",Asian Non-Hispanic,3,0,3
"
",90 Days to < 6 Months,All Ethnicities,106,1,105
"
","
",White Non-Hispanic,64,1,63
"
","
",Black Non-Hispanic,29,0,29
"
","
",Hispanic/Latino,6,0,6
"
","
",Asian Non-Hispanic,6,0,6
"
","
",American Indian/Alaska Native Non-Hispanic,1,0,1
"
",6 Months to < 1 Year,All Ethnicities,182,0,182
"
","
",White Non-Hispanic,98,0,98
"
","
",Black Non-Hispanic,59,0,59
"
","
",Hispanic/Latino,12,0,12
"
","
",Asian Non-Hispanic,12,0,12
"
","
",American Indian/Alaska Native Non-Hispanic,1,0,1
"
",1 Year to < 2 Years,All Ethnicities,291,0,291
"
","
",White Non-Hispanic,157,0,157
"
","
",Black Non-Hispanic,99,0,99
"
","
",Hispanic/Latino,19,0,19
"
","
",Asian Non-Hispanic,13,0,13
"
","
",American Indian/Alaska Native Non-Hispanic,1,0,1
"
","
",Pacific Islander Non-Hispanic,2,0,2
"
",2 Years to < 3 Years,All Ethnicities,106,0,106
"
","
",White Non-Hispanic,68,0,68
"
","
",Black Non-Hispanic,31,0,31
"
","
",Hispanic/Latino,5,0,5
"
","
",Asian Non-Hispanic,2,0,2
"
",3 Years to < 5 Years,All Ethnicities,140,0,140
"
","
",White Non-Hispanic,82,0,82
"
","
",Black Non-Hispanic,38,0,38
"
","
",Hispanic/Latino,14,0,14
"
","
",Asian Non-Hispanic,4,0,4
"
","
",Multiracial Non-Hispanic,2,0,2
"
",5 or More Years,All Ethnicities,43,0,43
"
","
",White Non-Hispanic,20,0,20
"
","
","
","
","
","
"
"
","
",Black Non-Hispanic,18,0,18
"
","
",Hispanic/Latino,3,0,3
"
","
",Asian Non-Hispanic,2,0,2
KYDA-OP1 Kentucky Organ Donor Affiliates,All Time,All Ethnicities,839,8,831
"
","
",White Non-Hispanic,555,7,548
"
","
",Black Non-Hispanic,244,0,244
"
","
",Hispanic/Latino,17,1,16
"
","
",Asian Non-Hispanic,20,0,20
"
","
",Pacific Islander Non-Hispanic,1,0,1
"
","
",Multiracial Non-Hispanic,2,0,2
"
",< 30 Days,All Ethnicities,54,0,54
"
","
",White Non-Hispanic,39,0,39
"
","
",Black Non-Hispanic,15,0,15
"
",30 to < 90 Days,All Ethnicities,49,0,49
"
","
",White Non-Hispanic,35,0,35
"
","
",Black Non-Hispanic,11,0,11
"
","
",Hispanic/Latino,1,0,1
"
","
",Asian Non-Hispanic,2,0,2
"
",90 Days to < 6 Months,All Ethnicities,75,1,74
"
","
",White Non-Hispanic,54,1,53
"
","
",Black Non-Hispanic,20,0,20
"
","
",Asian Non-Hispanic,1,0,1
"
",6 Months to < 1 Year,All Ethnicities,164,2,162
"
","
",White Non-Hispanic,111,2,109
"
","
",Black Non-Hispanic,46,0,46
"
","
",Hispanic/Latino,3,0,3
"
","
",Asian Non-Hispanic,4,0,4
"
",1 Year to < 2 Years,All Ethnicities,220,2,218
"
","
",White Non-Hispanic,134,1,133
"
","
",Black Non-Hispanic,71,0,71
"
","
",Hispanic/Latino,8,1,7
"
","
",Asian Non-Hispanic,6,0,6
"
","
",Pacific Islander Non-Hispanic,1,0,1
"
",2 Years to < 3 Years,All Ethnicities,129,3,126
"
","
",White Non-Hispanic,83,3,80
"
","
",Black Non-Hispanic,42,0,42
"
","
",Hispanic/Latino,1,0,1
"
","
",Asian Non-Hispanic,3,0,3
"
",3 Years to < 5 Years,All Ethnicities,119,0,119
"
","
",White Non-Hispanic,74,0,74
"
","
",Black Non-Hispanic,36,0,36
"
","
","
","
","
","
"
"
","
",Hispanic/Latino,3,0,3
"
","
",Asian Non-Hispanic,4,0,4
"
","
",Multiracial Non-Hispanic,2,0,2
"
",5 or More Years,All Ethnicities,29,0,29
"
","
",White Non-Hispanic,25,0,25
"
","
",Black Non-Hispanic,3,0,3
"
","
",Hispanic/Latino,1,0,1
LAOP-OP1 Louisiana Organ Procurement Agency,All Time,All Ethnicities,1733,17,1716
"
","
",White Non-Hispanic,481,4,477
"
","
",Black Non-Hispanic,1171,11,1160
"
","
",Hispanic/Latino,46,2,44
"
","
",Asian Non-Hispanic,28,0,28
"
","
",American Indian/Alaska Native Non-Hispanic,3,0,3
"
","
",Pacific Islander Non-Hispanic,4,0,4
"
",< 30 Days,All Ethnicities,61,5,56
"
","
",White Non-Hispanic,18,1,17
"
","
",Black Non-Hispanic,42,3,39
"
","
",Hispanic/Latino,1,1,0
"
",30 to < 90 Days,All Ethnicities,135,2,133
"
","
",White Non-Hispanic,49,0,49
"
","
",Black Non-Hispanic,79,2,77
"
","
",Hispanic/Latino,5,0,5
"
","
",Asian Non-Hispanic,1,0,1
"
","
",Pacific Islander Non-Hispanic,1,0,1
"
",90 Days to < 6 Months,All Ethnicities,155,2,153
"
","
",White Non-Hispanic,52,0,52
"
","
",Black Non-Hispanic,97,1,96
"
","
",Hispanic/Latino,5,1,4
"
","
",Asian Non-Hispanic,1,0,1
"
",6 Months to < 1 Year,All Ethnicities,296,3,293
"
","
",White Non-Hispanic,78,1,77
"
","
",Black Non-Hispanic,203,2,201
"
","
",Hispanic/Latino,7,0,7
"
","
",Asian Non-Hispanic,6,0,6
"
","
",American Indian/Alaska Native Non-Hispanic,1,0,1
"
","
",Pacific Islander Non-Hispanic,1,0,1
"
",1 Year to < 2 Years,All Ethnicities,381,4,377
"
","
",White Non-Hispanic,99,2,97
"
","
",Black Non-Hispanic,264,2,262
"
","
",Hispanic/Latino,8,0,8
"
","
",Asian Non-Hispanic,8,0,8
"
","
","
","
","
","
"
"
","
",American Indian/Alaska Native Non-Hispanic,1,0,1
"
","
",Pacific Islander Non-Hispanic,1,0,1
"
",2 Years to < 3 Years,All Ethnicities,259,1,258
"
","
",White Non-Hispanic,68,0,68
"
","
",Black Non-Hispanic,180,1,179
"
","
",Hispanic/Latino,8,0,8
"
","
",Asian Non-Hispanic,1,0,1
"
","
",American Indian/Alaska Native Non-Hispanic,1,0,1
"
","
",Pacific Islander Non-Hispanic,1,0,1
"
",3 Years to < 5 Years,All Ethnicities,279,0,279
"
","
",White Non-Hispanic,79,0,79
"
","
",Black Non-Hispanic,187,0,187
"
","
",Hispanic/Latino,8,0,8
"
","
",Asian Non-Hispanic,5,0,5
"
",5 or More Years,All Ethnicities,167,0,167
"
","
",White Non-Hispanic,38,0,38
"
","
",Black Non-Hispanic,119,0,119
"
","
",Hispanic/Latino,4,0,4
"
","
",Asian Non-Hispanic,6,0,6
MAOB-OP1 New England Organ Bank,All Time,All Ethnicities,5264,43,5221
"
","
",White Non-Hispanic,2990,22,2968
"
","
",Black Non-Hispanic,1075,3,1072
"
","
",Hispanic/Latino,776,15,761
"
","
",Asian Non-Hispanic,365,2,363
"
","
",American Indian/Alaska Native Non-Hispanic,11,0,11
"
","
",Pacific Islander Non-Hispanic,10,0,10
"
","
",Multiracial Non-Hispanic,37,1,36
"
",< 30 Days,All Ethnicities,178,2,176
"
","
",White Non-Hispanic,120,1,119
"
","
",Black Non-Hispanic,25,0,25
"
","
",Hispanic/Latino,21,0,21
"
","
",Asian Non-Hispanic,9,0,9
"
","
",Pacific Islander Non-Hispanic,1,0,1
"
","
",Multiracial Non-Hispanic,2,1,1
"
",30 to < 90 Days,All Ethnicities,247,12,235
"
","
",White Non-Hispanic,141,5,136
"
","
",Black Non-Hispanic,50,1,49
"
","
",Hispanic/Latino,39,5,34
"
","
",Asian Non-Hispanic,16,1,15
"
","
",Multiracial Non-Hispanic,1,0,1
"
",90 Days to < 6 Months,All Ethnicities,398,6,392
"
","
","
","
","
","
"
"
","
",White Non-Hispanic,239,4,235
"
","
",Black Non-Hispanic,75,0,75
"
","
",Hispanic/Latino,57,2,55
"
","
",Asian Non-Hispanic,25,0,25
"
","
",Multiracial Non-Hispanic,2,0,2
"
",6 Months to < 1 Year,All Ethnicities,678,7,671
"
","
",White Non-Hispanic,399,3,396
"
","
",Black Non-Hispanic,126,1,125
"
","
",Hispanic/Latino,103,2,101
"
","
",Asian Non-Hispanic,42,1,41
"
","
",American Indian/Alaska Native Non-Hispanic,2,0,2
"
","
",Pacific Islander Non-Hispanic,3,0,3
"
","
",Multiracial Non-Hispanic,3,0,3
"
",1 Year to < 2 Years,All Ethnicities,1270,11,1259
"
","
",White Non-Hispanic,716,7,709
"
","
",Black Non-Hispanic,260,1,259
"
","
",Hispanic/Latino,181,3,178
"
","
",Asian Non-Hispanic,100,0,100
"
","
",Pacific Islander Non-Hispanic,2,0,2
"
","
",Multiracial Non-Hispanic,11,0,11
"
",2 Years to < 3 Years,All Ethnicities,913,4,909
"
","
",White Non-Hispanic,519,2,517
"
","
",Black Non-Hispanic,172,0,172
"
","
",Hispanic/Latino,149,2,147
"
","
",Asian Non-Hispanic,64,0,64
"
","
",American Indian/Alaska Native Non-Hispanic,2,0,2
"
","
",Multiracial Non-Hispanic,7,0,7
"
",3 Years to < 5 Years,All Ethnicities,984,1,983
"
","
",White Non-Hispanic,535,0,535
"
","
",Black Non-Hispanic,224,0,224
"
","
",Hispanic/Latino,149,1,148
"
","
",Asian Non-Hispanic,63,0,63
"
","
",American Indian/Alaska Native Non-Hispanic,5,0,5
"
","
",Pacific Islander Non-Hispanic,4,0,4
"
","
",Multiracial Non-Hispanic,4,0,4
"
",5 or More Years,All Ethnicities,596,0,596
"
","
",White Non-Hispanic,321,0,321
"
","
",Black Non-Hispanic,143,0,143
"
","
",Hispanic/Latino,77,0,77
"
","
",Asian Non-Hispanic,46,0,46
"
","
",American Indian/Alaska Native Non-Hispanic,2,0,2
"
","
","
","
","
","
"
"
","
",Multiracial Non-Hispanic,7,0,7
MDPC-OP1 Infinite Legacy,All Time,All Ethnicities,3483,28,3455
"
","
",White Non-Hispanic,967,12,955
"
","
",Black Non-Hispanic,1884,7,1877
"
","
",Hispanic/Latino,279,7,272
"
","
",Asian Non-Hispanic,326,1,325
"
","
",American Indian/Alaska Native Non-Hispanic,5,0,5
"
","
",Pacific Islander Non-Hispanic,3,0,3
"
","
",Multiracial Non-Hispanic,19,1,18
"
",< 30 Days,All Ethnicities,139,1,138
"
","
",White Non-Hispanic,30,1,29
"
","
",Black Non-Hispanic,77,0,77
"
","
",Hispanic/Latino,18,0,18
"
","
",Asian Non-Hispanic,11,0,11
"
","
",Multiracial Non-Hispanic,3,0,3
"
",30 to < 90 Days,All Ethnicities,228,2,226
"
","
",White Non-Hispanic,54,1,53
"
","
",Black Non-Hispanic,129,0,129
"
","
",Hispanic/Latino,19,1,18
"
","
",Asian Non-Hispanic,22,0,22
"
","
",Multiracial Non-Hispanic,4,0,4
"
",90 Days to < 6 Months,All Ethnicities,292,4,288
"
","
",White Non-Hispanic,73,1,72
"
","
",Black Non-Hispanic,161,1,160
"
","
",Hispanic/Latino,20,1,19
"
","
",Asian Non-Hispanic,35,1,34
"
","
",Pacific Islander Non-Hispanic,1,0,1
"
","
",Multiracial Non-Hispanic,2,0,2
"
",6 Months to < 1 Year,All Ethnicities,504,5,499
"
","
",White Non-Hispanic,123,4,119
"
","
",Black Non-Hispanic,284,1,283
"
","
",Hispanic/Latino,45,0,45
"
","
",Asian Non-Hispanic,49,0,49
"
","
",American Indian/Alaska Native Non-Hispanic,1,0,1
"
","
",Multiracial Non-Hispanic,2,0,2
"
",1 Year to < 2 Years,All Ethnicities,801,7,794
"
","
",White Non-Hispanic,232,2,230
"
","
",Black Non-Hispanic,396,2,394
"
","
",Hispanic/Latino,80,2,78
"
","
",Asian Non-Hispanic,89,0,89
"
","
",American Indian/Alaska Native Non-Hispanic,1,0,1
"
","
","
","
","
","
"
"
","
",Pacific Islander Non-Hispanic,1,0,1
"
","
",Multiracial Non-Hispanic,2,1,1
"
",2 Years to < 3 Years,All Ethnicities,454,4,450
"
","
",White Non-Hispanic,124,1,123
"
","
",Black Non-Hispanic,254,2,252
"
","
",Hispanic/Latino,34,1,33
"
","
",Asian Non-Hispanic,41,0,41
"
","
",American Indian/Alaska Native Non-Hispanic,1,0,1
"
",3 Years to < 5 Years,All Ethnicities,622,1,621
"
","
",White Non-Hispanic,180,1,179
"
","
",Black Non-Hispanic,332,0,332
"
","
",Hispanic/Latino,39,0,39
"
","
",Asian Non-Hispanic,63,0,63
"
","
",American Indian/Alaska Native Non-Hispanic,2,0,2
"
","
",Pacific Islander Non-Hispanic,1,0,1
"
","
",Multiracial Non-Hispanic,5,0,5
"
",5 or More Years,All Ethnicities,443,4,439
"
","
",White Non-Hispanic,151,1,150
"
","
",Black Non-Hispanic,251,1,250
"
","
",Hispanic/Latino,24,2,22
"
","
",Asian Non-Hispanic,16,0,16
"
","
",Multiracial Non-Hispanic,1,0,1
MIOP-OP1 Gift of Life Michigan,All Time,All Ethnicities,2030,14,2016
"
","
",White Non-Hispanic,1141,8,1133
"
","
",Black Non-Hispanic,667,3,664
"
","
",Hispanic/Latino,102,2,100
"
","
",Asian Non-Hispanic,73,0,73
"
","
",American Indian/Alaska Native Non-Hispanic,18,0,18
"
","
",Pacific Islander Non-Hispanic,3,0,3
"
","
",Multiracial Non-Hispanic,26,1,25
"
",< 30 Days,All Ethnicities,100,2,98
"
","
",White Non-Hispanic,48,1,47
"
","
",Black Non-Hispanic,43,1,42
"
","
",Hispanic/Latino,3,0,3
"
","
",Asian Non-Hispanic,3,0,3
"
","
",American Indian/Alaska Native Non-Hispanic,2,0,2
"
","
",Multiracial Non-Hispanic,1,0,1
"
",30 to < 90 Days,All Ethnicities,156,1,155
"
","
",White Non-Hispanic,87,0,87
"
","
",Black Non-Hispanic,53,1,52
"
","
",Hispanic/Latino,8,0,8
"
","
","
","
","
","
"
"
","
",Asian Non-Hispanic,6,0,6
"
","
",American Indian/Alaska Native Non-Hispanic,1,0,1
"
","
",Multiracial Non-Hispanic,1,0,1
"
",90 Days to < 6 Months,All Ethnicities,206,2,204
"
","
",White Non-Hispanic,135,1,134
"
","
",Black Non-Hispanic,57,0,57
"
","
",Hispanic/Latino,6,0,6
"
","
",Asian Non-Hispanic,5,0,5
"
","
",Multiracial Non-Hispanic,3,1,2
"
",6 Months to < 1 Year,All Ethnicities,339,3,336
"
","
",White Non-Hispanic,193,2,191
"
","
",Black Non-Hispanic,102,0,102
"
","
",Hispanic/Latino,23,1,22
"
","
",Asian Non-Hispanic,15,0,15
"
","
",American Indian/Alaska Native Non-Hispanic,4,0,4
"
","
",Pacific Islander Non-Hispanic,1,0,1
"
","
",Multiracial Non-Hispanic,1,0,1
"
",1 Year to < 2 Years,All Ethnicities,526,2,524
"
","
",White Non-Hispanic,284,2,282
"
","
",Black Non-Hispanic,184,0,184
"
","
",Hispanic/Latino,21,0,21
"
","
",Asian Non-Hispanic,26,0,26
"
","
",American Indian/Alaska Native Non-Hispanic,2,0,2
"
","
",Pacific Islander Non-Hispanic,1,0,1
"
","
",Multiracial Non-Hispanic,8,0,8
"
",2 Years to < 3 Years,All Ethnicities,257,0,257
"
","
",White Non-Hispanic,141,0,141
"
","
",Black Non-Hispanic,74,0,74
"
","
",Hispanic/Latino,21,0,21
"
","
",Asian Non-Hispanic,9,0,9
"
","
",American Indian/Alaska Native Non-Hispanic,5,0,5
"
","
",Multiracial Non-Hispanic,7,0,7
"
",3 Years to < 5 Years,All Ethnicities,261,3,258
"
","
",White Non-Hispanic,157,2,155
"
","
",Black Non-Hispanic,76,0,76
"
","
",Hispanic/Latino,14,1,13
"
","
",Asian Non-Hispanic,6,0,6
"
","
",American Indian/Alaska Native Non-Hispanic,3,0,3
"
","
",Multiracial Non-Hispanic,5,0,5
"
",5 or More Years,All Ethnicities,185,1,184
"
","
",White Non-Hispanic,96,0,96
"
","
","
","
","
","
"
"
","
",Black Non-Hispanic,78,1,77
"
","
",Hispanic/Latino,6,0,6
"
","
",Asian Non-Hispanic,3,0,3
"
","
",American Indian/Alaska Native Non-Hispanic,1,0,1
"
","
",Pacific Islander Non-Hispanic,1,0,1
MNOP-OP1 LifeSource Upper Midwest Organ Procurement Organization,All Time,All Ethnicities,2395,42,2353
"
","
",White Non-Hispanic,1492,20,1472
"
","
",Black Non-Hispanic,327,8,319
"
","
",Hispanic/Latino,166,5,161
"
","
",Asian Non-Hispanic,229,5,224
"
","
",American Indian/Alaska Native Non-Hispanic,138,2,136
"
","
",Pacific Islander Non-Hispanic,6,0,6
"
","
",Multiracial Non-Hispanic,37,2,35
"
",< 30 Days,All Ethnicities,100,1,99
"
","
",White Non-Hispanic,58,0,58
"
","
",Black Non-Hispanic,16,0,16
"
","
",Hispanic/Latino,12,0,12
"
","
",Asian Non-Hispanic,7,1,6
"
","
",American Indian/Alaska Native Non-Hispanic,6,0,6
"
","
",Pacific Islander Non-Hispanic,1,0,1
"
",30 to < 90 Days,All Ethnicities,156,3,153
"
","
",White Non-Hispanic,106,2,104
"
","
",Black Non-Hispanic,23,0,23
"
","
",Hispanic/Latino,6,0,6
"
","
",Asian Non-Hispanic,7,1,6
"
","
",American Indian/Alaska Native Non-Hispanic,11,0,11
"
","
",Multiracial Non-Hispanic,3,0,3
"
",90 Days to < 6 Months,All Ethnicities,186,5,181
"
","
",White Non-Hispanic,116,1,115
"
","
",Black Non-Hispanic,25,1,24
"
","
",Hispanic/Latino,13,1,12
"
","
",Asian Non-Hispanic,19,0,19
"
","
",American Indian/Alaska Native Non-Hispanic,8,1,7
"
","
",Pacific Islander Non-Hispanic,2,0,2
"
","
",Multiracial Non-Hispanic,3,1,2
"
",6 Months to < 1 Year,All Ethnicities,391,8,383
"
","
",White Non-Hispanic,239,2,237
"
","
",Black Non-Hispanic,49,3,46
"
","
",Hispanic/Latino,27,2,25
"
","
",Asian Non-Hispanic,44,0,44
"
","
",American Indian/Alaska Native Non-Hispanic,26,0,26
"
","
","
","
","
","
"
"
","
",Pacific Islander Non-Hispanic,2,0,2
"
","
",Multiracial Non-Hispanic,4,1,3
"
",1 Year to < 2 Years,All Ethnicities,546,14,532
"
","
",White Non-Hispanic,352,8,344
"
","
",Black Non-Hispanic,76,3,73
"
","
",Hispanic/Latino,32,1,31
"
","
",Asian Non-Hispanic,45,1,44
"
","
",American Indian/Alaska Native Non-Hispanic,33,1,32
"
","
",Pacific Islander Non-Hispanic,1,0,1
"
","
",Multiracial Non-Hispanic,7,0,7
"
",2 Years to < 3 Years,All Ethnicities,318,6,312
"
","
",White Non-Hispanic,205,3,202
"
","
",Black Non-Hispanic,37,1,36
"
","
",Hispanic/Latino,24,1,23
"
","
",Asian Non-Hispanic,29,1,28
"
","
",American Indian/Alaska Native Non-Hispanic,19,0,19
"
","
",Multiracial Non-Hispanic,4,0,4
"
",3 Years to < 5 Years,All Ethnicities,365,3,362
"
","
",White Non-Hispanic,218,3,215
"
","
",Black Non-Hispanic,54,0,54
"
","
",Hispanic/Latino,31,0,31
"
","
",Asian Non-Hispanic,37,0,37
"
","
",American Indian/Alaska Native Non-Hispanic,22,0,22
"
","
",Multiracial Non-Hispanic,3,0,3
"
",5 or More Years,All Ethnicities,333,2,331
"
","
",White Non-Hispanic,198,1,197
"
","
",Black Non-Hispanic,47,0,47
"
","
",Hispanic/Latino,21,0,21
"
","
",Asian Non-Hispanic,41,1,40
"
","
",American Indian/Alaska Native Non-Hispanic,13,0,13
"
","
",Multiracial Non-Hispanic,13,0,13
MOMA-OP1 Mid-America Transplant Services,All Time,All Ethnicities,1118,11,1107
"
","
",White Non-Hispanic,654,8,646
"
","
",Black Non-Hispanic,395,1,394
"
","
",Hispanic/Latino,23,1,22
"
","
",Asian Non-Hispanic,37,1,36
"
","
",American Indian/Alaska Native Non-Hispanic,5,0,5
"
","
",Pacific Islander Non-Hispanic,2,0,2
"
","
",Multiracial Non-Hispanic,2,0,2
"
",< 30 Days,All Ethnicities,49,3,46
"
","
",White Non-Hispanic,34,2,32
"
","
","
","
","
","
"
"
","
",Black Non-Hispanic,14,0,14
"
","
",Asian Non-Hispanic,1,1,0
"
",30 to < 90 Days,All Ethnicities,88,3,85
"
","
",White Non-Hispanic,58,3,55
"
","
",Black Non-Hispanic,24,0,24
"
","
",Hispanic/Latino,3,0,3
"
","
",Asian Non-Hispanic,2,0,2
"
","
",American Indian/Alaska Native Non-Hispanic,1,0,1
"
",90 Days to < 6 Months,All Ethnicities,122,3,119
"
","
",White Non-Hispanic,78,1,77
"
","
",Black Non-Hispanic,34,1,33
"
","
",Hispanic/Latino,5,1,4
"
","
",Asian Non-Hispanic,4,0,4
"
","
",Pacific Islander Non-Hispanic,1,0,1
"
",6 Months to < 1 Year,All Ethnicities,197,0,197
"
","
",White Non-Hispanic,115,0,115
"
","
",Black Non-Hispanic,76,0,76
"
","
",Hispanic/Latino,2,0,2
"
","
",Asian Non-Hispanic,2,0,2
"
","
",American Indian/Alaska Native Non-Hispanic,1,0,1
"
","
",Pacific Islander Non-Hispanic,1,0,1
"
",1 Year to < 2 Years,All Ethnicities,270,1,269
"
","
",White Non-Hispanic,166,1,165
"
","
",Black Non-Hispanic,91,0,91
"
","
",Hispanic/Latino,2,0,2
"
","
",Asian Non-Hispanic,9,0,9
"
","
",American Indian/Alaska Native Non-Hispanic,2,0,2
"
",2 Years to < 3 Years,All Ethnicities,170,0,170
"
","
",White Non-Hispanic,89,0,89
"
","
",Black Non-Hispanic,62,0,62
"
","
",Hispanic/Latino,6,0,6
"
","
",Asian Non-Hispanic,10,0,10
"
","
",American Indian/Alaska Native Non-Hispanic,1,0,1
"
","
",Multiracial Non-Hispanic,2,0,2
"
",3 Years to < 5 Years,All Ethnicities,116,0,116
"
","
",White Non-Hispanic,67,0,67
"
","
",Black Non-Hispanic,42,0,42
"
","
",Hispanic/Latino,3,0,3
"
","
",Asian Non-Hispanic,4,0,4
"
",5 or More Years,All Ethnicities,106,1,105
"
","
",White Non-Hispanic,47,1,46
"
","
","
","
","
","
"
"
","
",Black Non-Hispanic,52,0,52
"
","
",Hispanic/Latino,2,0,2
"
","
",Asian Non-Hispanic,5,0,5
MSOP-OP1 Mississippi Organ Recovery Agency,All Time,All Ethnicities,489,0,489
"
","
",White Non-Hispanic,88,0,88
"
","
",Black Non-Hispanic,387,0,387
"
","
",Hispanic/Latino,4,0,4
"
","
",Asian Non-Hispanic,6,0,6
"
","
",American Indian/Alaska Native Non-Hispanic,4,0,4
"
",< 30 Days,All Ethnicities,23,0,23
"
","
",White Non-Hispanic,4,0,4
"
","
",Black Non-Hispanic,19,0,19
"
",30 to < 90 Days,All Ethnicities,15,0,15
"
","
",White Non-Hispanic,3,0,3
"
","
",Black Non-Hispanic,12,0,12
"
",90 Days to < 6 Months,All Ethnicities,10,0,10
"
","
",White Non-Hispanic,4,0,4
"
","
",Black Non-Hispanic,6,0,6
"
",6 Months to < 1 Year,All Ethnicities,24,0,24
"
","
",White Non-Hispanic,5,0,5
"
","
",Black Non-Hispanic,19,0,19
"
",1 Year to < 2 Years,All Ethnicities,126,0,126
"
","
",White Non-Hispanic,27,0,27
"
","
",Black Non-Hispanic,93,0,93
"
","
",Hispanic/Latino,2,0,2
"
","
",Asian Non-Hispanic,2,0,2
"
","
",American Indian/Alaska Native Non-Hispanic,2,0,2
"
",2 Years to < 3 Years,All Ethnicities,124,0,124
"
","
",White Non-Hispanic,16,0,16
"
","
",Black Non-Hispanic,104,0,104
"
","
",Hispanic/Latino,1,0,1
"
","
",Asian Non-Hispanic,1,0,1
"
","
",American Indian/Alaska Native Non-Hispanic,2,0,2
"
",3 Years to < 5 Years,All Ethnicities,123,0,123
"
","
",White Non-Hispanic,24,0,24
"
","
",Black Non-Hispanic,95,0,95
"
","
",Hispanic/Latino,1,0,1
"
","
",Asian Non-Hispanic,3,0,3
"
",5 or More Years,All Ethnicities,44,0,44
"
","
",White Non-Hispanic,5,0,5
"
","
",Black Non-Hispanic,39,0,39
"
","
","
","
","
","
"
MWOB-OP1 Midwest Transplant Network,All Time,All Ethnicities,776,30,746
"
","
",White Non-Hispanic,488,16,472
"
","
",Black Non-Hispanic,162,6,156
"
","
",Hispanic/Latino,65,4,61
"
","
",Asian Non-Hispanic,34,0,34
"
","
",American Indian/Alaska Native Non-Hispanic,4,0,4
"
","
",Pacific Islander Non-Hispanic,1,0,1
"
","
",Multiracial Non-Hispanic,22,4,18
"
",< 30 Days,All Ethnicities,59,2,57
"
","
",White Non-Hispanic,38,2,36
"
","
",Black Non-Hispanic,9,0,9
"
","
",Hispanic/Latino,9,0,9
"
","
",Asian Non-Hispanic,3,0,3
"
",30 to < 90 Days,All Ethnicities,90,6,84
"
","
",White Non-Hispanic,55,3,52
"
","
",Black Non-Hispanic,21,0,21
"
","
",Hispanic/Latino,10,3,7
"
","
",Asian Non-Hispanic,3,0,3
"
","
",Multiracial Non-Hispanic,1,0,1
"
",90 Days to < 6 Months,All Ethnicities,65,1,64
"
","
",White Non-Hispanic,41,0,41
"
","
",Black Non-Hispanic,16,0,16
"
","
",Hispanic/Latino,3,0,3
"
","
",Asian Non-Hispanic,2,0,2
"
","
",Multiracial Non-Hispanic,3,1,2
"
",6 Months to < 1 Year,All Ethnicities,153,8,145
"
","
",White Non-Hispanic,90,1,89
"
","
",Black Non-Hispanic,33,3,30
"
","
",Hispanic/Latino,13,1,12
"
","
",Asian Non-Hispanic,9,0,9
"
","
",American Indian/Alaska Native Non-Hispanic,1,0,1
"
","
",Multiracial Non-Hispanic,7,3,4
"
",1 Year to < 2 Years,All Ethnicities,212,3,209
"
","
",White Non-Hispanic,136,2,134
"
","
",Black Non-Hispanic,40,1,39
"
","
",Hispanic/Latino,20,0,20
"
","
",Asian Non-Hispanic,10,0,10
"
","
",American Indian/Alaska Native Non-Hispanic,1,0,1
"
","
",Multiracial Non-Hispanic,5,0,5
"
",2 Years to < 3 Years,All Ethnicities,94,5,89
"
","
",White Non-Hispanic,52,4,48
"
","
","
","
","
","
"
"
","
",Black Non-Hispanic,27,1,26
"
","
",Hispanic/Latino,6,0,6
"
","
",Asian Non-Hispanic,6,0,6
"
","
",Pacific Islander Non-Hispanic,1,0,1
"
","
",Multiracial Non-Hispanic,2,0,2
"
",3 Years to < 5 Years,All Ethnicities,76,4,72
"
","
",White Non-Hispanic,58,3,55
"
","
",Black Non-Hispanic,11,1,10
"
","
",Hispanic/Latino,4,0,4
"
","
",Multiracial Non-Hispanic,3,0,3
"
",5 or More Years,All Ethnicities,27,1,26
"
","
",White Non-Hispanic,18,1,17
"
","
",Black Non-Hispanic,5,0,5
"
","
",Asian Non-Hispanic,1,0,1
"
","
",American Indian/Alaska Native Non-Hispanic,2,0,2
"
","
",Multiracial Non-Hispanic,1,0,1
NCCM-IO1 LifeShare Carolinas,All Time,All Ethnicities,769,15,754
"
","
",White Non-Hispanic,240,4,236
"
","
",Black Non-Hispanic,391,5,386
"
","
",Hispanic/Latino,55,3,52
"
","
",Asian Non-Hispanic,35,0,35
"
","
",American Indian/Alaska Native Non-Hispanic,2,0,2
"
","
",Multiracial Non-Hispanic,46,3,43
"
",< 30 Days,All Ethnicities,31,0,31
"
","
",White Non-Hispanic,8,0,8
"
","
",Black Non-Hispanic,20,0,20
"
","
",Hispanic/Latino,1,0,1
"
","
",Asian Non-Hispanic,2,0,2
"
",30 to < 90 Days,All Ethnicities,69,3,66
"
","
",White Non-Hispanic,28,0,28
"
","
",Black Non-Hispanic,34,1,33
"
","
",Hispanic/Latino,4,1,3
"
","
",Asian Non-Hispanic,1,0,1
"
","
",Multiracial Non-Hispanic,2,1,1
"
",90 Days to < 6 Months,All Ethnicities,73,5,68
"
","
",White Non-Hispanic,23,2,21
"
","
",Black Non-Hispanic,34,1,33
"
","
",Hispanic/Latino,10,1,9
"
","
",Asian Non-Hispanic,3,0,3
"
","
",Multiracial Non-Hispanic,3,1,2
"
",6 Months to < 1 Year,All Ethnicities,145,3,142
"
","
","
","
","
","
"
"
","
",White Non-Hispanic,39,0,39
"
","
",Black Non-Hispanic,86,3,83
"
","
",Hispanic/Latino,6,0,6
"
","
",Asian Non-Hispanic,10,0,10
"
","
",Multiracial Non-Hispanic,4,0,4
"
",1 Year to < 2 Years,All Ethnicities,155,3,152
"
","
",White Non-Hispanic,53,2,51
"
","
",Black Non-Hispanic,72,0,72
"
","
",Hispanic/Latino,10,1,9
"
","
",Asian Non-Hispanic,12,0,12
"
","
",American Indian/Alaska Native Non-Hispanic,1,0,1
"
","
",Multiracial Non-Hispanic,7,0,7
"
",2 Years to < 3 Years,All Ethnicities,98,0,98
"
","
",White Non-Hispanic,26,0,26
"
","
",Black Non-Hispanic,56,0,56
"
","
",Hispanic/Latino,8,0,8
"
","
",Asian Non-Hispanic,2,0,2
"
","
",Multiracial Non-Hispanic,6,0,6
"
",3 Years to < 5 Years,All Ethnicities,114,0,114
"
","
",White Non-Hispanic,39,0,39
"
","
",Black Non-Hispanic,50,0,50
"
","
",Hispanic/Latino,7,0,7
"
","
",Asian Non-Hispanic,4,0,4
"
","
",Multiracial Non-Hispanic,14,0,14
"
",5 or More Years,All Ethnicities,84,1,83
"
","
",White Non-Hispanic,24,0,24
"
","
",Black Non-Hispanic,39,0,39
"
","
",Hispanic/Latino,9,0,9
"
","
",Asian Non-Hispanic,1,0,1
"
","
",American Indian/Alaska Native Non-Hispanic,1,0,1
"
","
",Multiracial Non-Hispanic,10,1,9
NCNC-OP1 HonorBridge,All Time,All Ethnicities,2677,29,2648
"
","
",White Non-Hispanic,936,13,923
"
","
",Black Non-Hispanic,1449,9,1440
"
","
",Hispanic/Latino,143,4,139
"
","
",Asian Non-Hispanic,74,2,72
"
","
",American Indian/Alaska Native Non-Hispanic,34,0,34
"
","
",Pacific Islander Non-Hispanic,6,0,6
"
","
",Multiracial Non-Hispanic,35,1,34
"
",< 30 Days,All Ethnicities,127,5,122
"
","
",White Non-Hispanic,41,4,37
"
","
","
","
","
","
"
"
","
",Black Non-Hispanic,70,0,70
"
","
",Hispanic/Latino,7,1,6
"
","
",Asian Non-Hispanic,4,0,4
"
","
",American Indian/Alaska Native Non-Hispanic,3,0,3
"
","
",Multiracial Non-Hispanic,2,0,2
"
",30 to < 90 Days,All Ethnicities,178,2,176
"
","
",White Non-Hispanic,55,0,55
"
","
",Black Non-Hispanic,98,0,98
"
","
",Hispanic/Latino,14,1,13
"
","
",Asian Non-Hispanic,2,0,2
"
","
",American Indian/Alaska Native Non-Hispanic,1,0,1
"
","
",Pacific Islander Non-Hispanic,1,0,1
"
","
",Multiracial Non-Hispanic,7,1,6
"
",90 Days to < 6 Months,All Ethnicities,228,4,224
"
","
",White Non-Hispanic,74,1,73
"
","
",Black Non-Hispanic,121,2,119
"
","
",Hispanic/Latino,16,1,15
"
","
",Asian Non-Hispanic,7,0,7
"
","
",American Indian/Alaska Native Non-Hispanic,7,0,7
"
","
",Multiracial Non-Hispanic,3,0,3
"
",6 Months to < 1 Year,All Ethnicities,465,3,462
"
","
",White Non-Hispanic,185,0,185
"
","
",Black Non-Hispanic,231,2,229
"
","
",Hispanic/Latino,22,1,21
"
","
",Asian Non-Hispanic,12,0,12
"
","
",American Indian/Alaska Native Non-Hispanic,5,0,5
"
","
",Pacific Islander Non-Hispanic,2,0,2
"
","
",Multiracial Non-Hispanic,8,0,8
"
",1 Year to < 2 Years,All Ethnicities,644,9,635
"
","
",White Non-Hispanic,215,6,209
"
","
",Black Non-Hispanic,361,3,358
"
","
",Hispanic/Latino,35,0,35
"
","
",Asian Non-Hispanic,22,0,22
"
","
",American Indian/Alaska Native Non-Hispanic,5,0,5
"
","
",Pacific Islander Non-Hispanic,3,0,3
"
","
",Multiracial Non-Hispanic,3,0,3
"
",2 Years to < 3 Years,All Ethnicities,384,2,382
"
","
",White Non-Hispanic,137,1,136
"
","
",Black Non-Hispanic,212,1,211
"
","
",Hispanic/Latino,18,0,18
"
","
",Asian Non-Hispanic,9,0,9
"
","
","
","
","
","
"
"
","
",American Indian/Alaska Native Non-Hispanic,4,0,4
"
","
",Multiracial Non-Hispanic,4,0,4
"
",3 Years to < 5 Years,All Ethnicities,429,3,426
"
","
",White Non-Hispanic,144,1,143
"
","
",Black Non-Hispanic,241,1,240
"
","
",Hispanic/Latino,19,0,19
"
","
",Asian Non-Hispanic,11,1,10
"
","
",American Indian/Alaska Native Non-Hispanic,6,0,6
"
","
",Multiracial Non-Hispanic,8,0,8
"
",5 or More Years,All Ethnicities,222,1,221
"
","
",White Non-Hispanic,85,0,85
"
","
",Black Non-Hispanic,115,0,115
"
","
",Hispanic/Latino,12,0,12
"
","
",Asian Non-Hispanic,7,1,6
"
","
",American Indian/Alaska Native Non-Hispanic,3,0,3
NEOR-OP1 Live On Nebraska,All Time,All Ethnicities,245,2,243
"
","
",White Non-Hispanic,159,2,157
"
","
",Black Non-Hispanic,30,0,30
"
","
",Hispanic/Latino,28,0,28
"
","
",Asian Non-Hispanic,21,0,21
"
","
",American Indian/Alaska Native Non-Hispanic,4,0,4
"
","
",Pacific Islander Non-Hispanic,2,0,2
"
","
",Multiracial Non-Hispanic,1,0,1
"
",< 30 Days,All Ethnicities,25,1,24
"
","
",White Non-Hispanic,12,1,11
"
","
",Black Non-Hispanic,5,0,5
"
","
",Hispanic/Latino,4,0,4
"
","
",Asian Non-Hispanic,4,0,4
"
",30 to < 90 Days,All Ethnicities,38,0,38
"
","
",White Non-Hispanic,23,0,23
"
","
",Black Non-Hispanic,4,0,4
"
","
",Hispanic/Latino,2,0,2
"
","
",Asian Non-Hispanic,7,0,7
"
","
",Pacific Islander Non-Hispanic,1,0,1
"
","
",Multiracial Non-Hispanic,1,0,1
"
",90 Days to < 6 Months,All Ethnicities,45,0,45
"
","
",White Non-Hispanic,23,0,23
"
","
",Black Non-Hispanic,6,0,6
"
","
",Hispanic/Latino,10,0,10
"
","
",Asian Non-Hispanic,3,0,3
"
","
",American Indian/Alaska Native Non-Hispanic,2,0,2
"
","
","
","
","
","
"
"
","
",Pacific Islander Non-Hispanic,1,0,1
"
",6 Months to < 1 Year,All Ethnicities,54,0,54
"
","
",White Non-Hispanic,39,0,39
"
","
",Black Non-Hispanic,5,0,5
"
","
",Hispanic/Latino,7,0,7
"
","
",Asian Non-Hispanic,3,0,3
"
",1 Year to < 2 Years,All Ethnicities,60,1,59
"
","
",White Non-Hispanic,45,1,44
"
","
",Black Non-Hispanic,7,0,7
"
","
",Hispanic/Latino,4,0,4
"
","
",Asian Non-Hispanic,3,0,3
"
","
",American Indian/Alaska Native Non-Hispanic,1,0,1
"
",2 Years to < 3 Years,All Ethnicities,16,0,16
"
","
",White Non-Hispanic,12,0,12
"
","
",Black Non-Hispanic,1,0,1
"
","
",Hispanic/Latino,1,0,1
"
","
",Asian Non-Hispanic,1,0,1
"
","
",American Indian/Alaska Native Non-Hispanic,1,0,1
"
",3 Years to < 5 Years,All Ethnicities,6,0,6
"
","
",White Non-Hispanic,5,0,5
"
","
",Black Non-Hispanic,1,0,1
"
",5 or More Years,All Ethnicities,1,0,1
"
","
",Black Non-Hispanic,1,0,1
NJTO-OP1 New Jersey Organ and Tissue Sharing Network OPO,All Time,All Ethnicities,2395,31,2364
"
","
",White Non-Hispanic,763,6,757
"
","
",Black Non-Hispanic,893,5,888
"
","
",Hispanic/Latino,438,15,423
"
","
",Asian Non-Hispanic,293,4,289
"
","
",Multiracial Non-Hispanic,8,1,7
"
",< 30 Days,All Ethnicities,125,3,122
"
","
",White Non-Hispanic,55,0,55
"
","
",Black Non-Hispanic,35,0,35
"
","
",Hispanic/Latino,25,2,23
"
","
",Asian Non-Hispanic,9,0,9
"
","
",Multiracial Non-Hispanic,1,1,0
"
",30 to < 90 Days,All Ethnicities,151,2,149
"
","
",White Non-Hispanic,53,2,51
"
","
",Black Non-Hispanic,50,0,50
"
","
",Hispanic/Latino,28,0,28
"
","
",Asian Non-Hispanic,20,0,20
"
",90 Days to < 6 Months,All Ethnicities,219,5,214
"
","
","
","
","
","
"
"
","
",White Non-Hispanic,77,0,77
"
","
",Black Non-Hispanic,74,0,74
"
","
",Hispanic/Latino,44,4,40
"
","
",Asian Non-Hispanic,22,1,21
"
","
",Multiracial Non-Hispanic,2,0,2
"
",6 Months to < 1 Year,All Ethnicities,390,5,385
"
","
",White Non-Hispanic,122,0,122
"
","
",Black Non-Hispanic,132,1,131
"
","
",Hispanic/Latino,73,4,69
"
","
",Asian Non-Hispanic,60,0,60
"
","
",Multiracial Non-Hispanic,3,0,3
"
",1 Year to < 2 Years,All Ethnicities,541,6,535
"
","
",White Non-Hispanic,172,1,171
"
","
",Black Non-Hispanic,199,1,198
"
","
",Hispanic/Latino,107,3,104
"
","
",Asian Non-Hispanic,62,1,61
"
","
",Multiracial Non-Hispanic,1,0,1
"
",2 Years to < 3 Years,All Ethnicities,362,1,361
"
","
",White Non-Hispanic,112,0,112
"
","
",Black Non-Hispanic,143,1,142
"
","
",Hispanic/Latino,60,0,60
"
","
",Asian Non-Hispanic,46,0,46
"
","
",Multiracial Non-Hispanic,1,0,1
"
",3 Years to < 5 Years,All Ethnicities,402,3,399
"
","
",White Non-Hispanic,116,1,115
"
","
",Black Non-Hispanic,172,2,170
"
","
",Hispanic/Latino,63,0,63
"
","
",Asian Non-Hispanic,51,0,51
"
",5 or More Years,All Ethnicities,205,6,199
"
","
",White Non-Hispanic,56,2,54
"
","
",Black Non-Hispanic,88,0,88
"
","
",Hispanic/Latino,38,2,36
"
","
",Asian Non-Hispanic,23,2,21
NMOP-OP1 New Mexico Donor Services,All Time,All Ethnicities,443,3,440
"
","
",White Non-Hispanic,101,1,100
"
","
",Black Non-Hispanic,12,0,12
"
","
",Hispanic/Latino,217,1,216
"
","
",Asian Non-Hispanic,5,0,5
"
","
",American Indian/Alaska Native Non-Hispanic,107,1,106
"
","
",Pacific Islander Non-Hispanic,1,0,1
"
",< 30 Days,All Ethnicities,8,0,8
"
","
","
","
","
","
"
"
","
",White Non-Hispanic,1,0,1
"
","
",Black Non-Hispanic,1,0,1
"
","
",Hispanic/Latino,6,0,6
"
",30 to < 90 Days,All Ethnicities,27,0,27
"
","
",White Non-Hispanic,5,0,5
"
","
",Black Non-Hispanic,1,0,1
"
","
",Hispanic/Latino,16,0,16
"
","
",Asian Non-Hispanic,1,0,1
"
","
",American Indian/Alaska Native Non-Hispanic,4,0,4
"
",90 Days to < 6 Months,All Ethnicities,35,1,34
"
","
",White Non-Hispanic,16,0,16
"
","
",Black Non-Hispanic,1,0,1
"
","
",Hispanic/Latino,13,1,12
"
","
",American Indian/Alaska Native Non-Hispanic,5,0,5
"
",6 Months to < 1 Year,All Ethnicities,53,0,53
"
","
",White Non-Hispanic,15,0,15
"
","
",Black Non-Hispanic,1,0,1
"
","
",Hispanic/Latino,26,0,26
"
","
",Asian Non-Hispanic,1,0,1
"
","
",American Indian/Alaska Native Non-Hispanic,10,0,10
"
",1 Year to < 2 Years,All Ethnicities,80,0,80
"
","
",White Non-Hispanic,23,0,23
"
","
",Black Non-Hispanic,1,0,1
"
","
",Hispanic/Latino,36,0,36
"
","
",Asian Non-Hispanic,1,0,1
"
","
",American Indian/Alaska Native Non-Hispanic,19,0,19
"
",2 Years to < 3 Years,All Ethnicities,62,2,60
"
","
",White Non-Hispanic,10,1,9
"
","
",Black Non-Hispanic,1,0,1
"
","
",Hispanic/Latino,30,0,30
"
","
",American Indian/Alaska Native Non-Hispanic,21,1,20
"
",3 Years to < 5 Years,All Ethnicities,109,0,109
"
","
",White Non-Hispanic,20,0,20
"
","
",Black Non-Hispanic,4,0,4
"
","
",Hispanic/Latino,56,0,56
"
","
",Asian Non-Hispanic,1,0,1
"
","
",American Indian/Alaska Native Non-Hispanic,27,0,27
"
","
",Pacific Islander Non-Hispanic,1,0,1
"
",5 or More Years,All Ethnicities,69,0,69
"
","
",White Non-Hispanic,11,0,11
"
","
",Black Non-Hispanic,2,0,2
"
","
","
","
","
","
"
"
","
",Hispanic/Latino,34,0,34
"
","
",Asian Non-Hispanic,1,0,1
"
","
",American Indian/Alaska Native Non-Hispanic,21,0,21
NVLV-OP1 Nevada Donor Network,All Time,All Ethnicities,269,0,269
"
","
",White Non-Hispanic,54,0,54
"
","
",Black Non-Hispanic,62,0,62
"
","
",Hispanic/Latino,85,0,85
"
","
",Asian Non-Hispanic,56,0,56
"
","
",American Indian/Alaska Native Non-Hispanic,1,0,1
"
","
",Pacific Islander Non-Hispanic,6,0,6
"
","
",Multiracial Non-Hispanic,5,0,5
"
",< 30 Days,All Ethnicities,23,0,23
"
","
",White Non-Hispanic,8,0,8
"
","
",Black Non-Hispanic,4,0,4
"
","
",Hispanic/Latino,6,0,6
"
","
",Asian Non-Hispanic,4,0,4
"
","
",Multiracial Non-Hispanic,1,0,1
"
",30 to < 90 Days,All Ethnicities,38,0,38
"
","
",White Non-Hispanic,15,0,15
"
","
",Black Non-Hispanic,8,0,8
"
","
",Hispanic/Latino,10,0,10
"
","
",Asian Non-Hispanic,3,0,3
"
","
",American Indian/Alaska Native Non-Hispanic,1,0,1
"
","
",Pacific Islander Non-Hispanic,1,0,1
"
",90 Days to < 6 Months,All Ethnicities,40,0,40
"
","
",White Non-Hispanic,7,0,7
"
","
",Black Non-Hispanic,4,0,4
"
","
",Hispanic/Latino,13,0,13
"
","
",Asian Non-Hispanic,13,0,13
"
","
",Pacific Islander Non-Hispanic,1,0,1
"
","
",Multiracial Non-Hispanic,2,0,2
"
",6 Months to < 1 Year,All Ethnicities,70,0,70
"
","
",White Non-Hispanic,9,0,9
"
","
",Black Non-Hispanic,21,0,21
"
","
",Hispanic/Latino,23,0,23
"
","
",Asian Non-Hispanic,14,0,14
"
","
",Pacific Islander Non-Hispanic,2,0,2
"
","
",Multiracial Non-Hispanic,1,0,1
"
",1 Year to < 2 Years,All Ethnicities,54,0,54
"
","
",White Non-Hispanic,9,0,9
"
","
",Black Non-Hispanic,13,0,13
"
","
","
","
","
","
"
"
","
",Hispanic/Latino,18,0,18
"
","
",Asian Non-Hispanic,13,0,13
"
","
",Pacific Islander Non-Hispanic,1,0,1
"
",2 Years to < 3 Years,All Ethnicities,24,0,24
"
","
",White Non-Hispanic,4,0,4
"
","
",Black Non-Hispanic,9,0,9
"
","
",Hispanic/Latino,6,0,6
"
","
",Asian Non-Hispanic,4,0,4
"
","
",Pacific Islander Non-Hispanic,1,0,1
"
",3 Years to < 5 Years,All Ethnicities,10,0,10
"
","
",White Non-Hispanic,1,0,1
"
","
",Black Non-Hispanic,1,0,1
"
","
",Hispanic/Latino,5,0,5
"
","
",Asian Non-Hispanic,2,0,2
"
","
",Multiracial Non-Hispanic,1,0,1
"
",5 or More Years,All Ethnicities,10,0,10
"
","
",White Non-Hispanic,1,0,1
"
","
",Black Non-Hispanic,2,0,2
"
","
",Hispanic/Latino,4,0,4
"
","
",Asian Non-Hispanic,3,0,3
NYAP-OP1 Center for Donation and Transplant,All Time,All Ethnicities,297,3,294
"
","
",White Non-Hispanic,232,2,230
"
","
",Black Non-Hispanic,33,0,33
"
","
",Hispanic/Latino,12,0,12
"
","
",Asian Non-Hispanic,13,0,13
"
","
",American Indian/Alaska Native Non-Hispanic,3,0,3
"
","
",Multiracial Non-Hispanic,4,1,3
"
",< 30 Days,All Ethnicities,12,0,12
"
","
",White Non-Hispanic,6,0,6
"
","
",Black Non-Hispanic,2,0,2
"
","
",Hispanic/Latino,1,0,1
"
","
",Asian Non-Hispanic,2,0,2
"
","
",American Indian/Alaska Native Non-Hispanic,1,0,1
"
",30 to < 90 Days,All Ethnicities,17,1,16
"
","
",White Non-Hispanic,14,0,14
"
","
",Black Non-Hispanic,2,0,2
"
","
",Multiracial Non-Hispanic,1,1,0
"
",90 Days to < 6 Months,All Ethnicities,27,0,27
"
","
",White Non-Hispanic,23,0,23
"
","
",Black Non-Hispanic,2,0,2
"
","
",Hispanic/Latino,2,0,2
"
","
","
","
","
","
"
"
",6 Months to < 1 Year,All Ethnicities,37,1,36
"
","
",White Non-Hispanic,25,1,24
"
","
",Black Non-Hispanic,7,0,7
"
","
",Hispanic/Latino,3,0,3
"
","
",Asian Non-Hispanic,1,0,1
"
","
",Multiracial Non-Hispanic,1,0,1
"
",1 Year to < 2 Years,All Ethnicities,81,0,81
"
","
",White Non-Hispanic,66,0,66
"
","
",Black Non-Hispanic,8,0,8
"
","
",Hispanic/Latino,2,0,2
"
","
",Asian Non-Hispanic,5,0,5
"
",2 Years to < 3 Years,All Ethnicities,47,1,46
"
","
",White Non-Hispanic,39,1,38
"
","
",Black Non-Hispanic,3,0,3
"
","
",Hispanic/Latino,1,0,1
"
","
",Asian Non-Hispanic,1,0,1
"
","
",American Indian/Alaska Native Non-Hispanic,2,0,2
"
","
",Multiracial Non-Hispanic,1,0,1
"
",3 Years to < 5 Years,All Ethnicities,51,0,51
"
","
",White Non-Hispanic,38,0,38
"
","
",Black Non-Hispanic,7,0,7
"
","
",Hispanic/Latino,1,0,1
"
","
",Asian Non-Hispanic,4,0,4
"
","
",Multiracial Non-Hispanic,1,0,1
"
",5 or More Years,All Ethnicities,25,0,25
"
","
",White Non-Hispanic,21,0,21
"
","
",Black Non-Hispanic,2,0,2
"
","
",Hispanic/Latino,2,0,2
NYFL-IO1 Finger Lakes Donor Recovery Network,All Time,All Ethnicities,743,8,735
"
","
",White Non-Hispanic,498,5,493
"
","
",Black Non-Hispanic,156,2,154
"
","
",Hispanic/Latino,45,0,45
"
","
",Asian Non-Hispanic,30,0,30
"
","
",American Indian/Alaska Native Non-Hispanic,5,0,5
"
","
",Pacific Islander Non-Hispanic,2,0,2
"
","
",Multiracial Non-Hispanic,7,1,6
"
",< 30 Days,All Ethnicities,33,1,32
"
","
",White Non-Hispanic,22,1,21
"
","
",Black Non-Hispanic,5,0,5
"
","
",Hispanic/Latino,2,0,2
"
","
",American Indian/Alaska Native Non-Hispanic,2,0,2
"
","
","
","
","
","
"
"
","
",Pacific Islander Non-Hispanic,2,0,2
"
",30 to < 90 Days,All Ethnicities,53,1,52
"
","
",White Non-Hispanic,35,1,34
"
","
",Black Non-Hispanic,12,0,12
"
","
",Hispanic/Latino,3,0,3
"
","
",Asian Non-Hispanic,3,0,3
"
",90 Days to < 6 Months,All Ethnicities,71,1,70
"
","
",White Non-Hispanic,50,0,50
"
","
",Black Non-Hispanic,18,1,17
"
","
",Hispanic/Latino,2,0,2
"
","
",Asian Non-Hispanic,1,0,1
"
",6 Months to < 1 Year,All Ethnicities,121,4,117
"
","
",White Non-Hispanic,82,2,80
"
","
",Black Non-Hispanic,22,1,21
"
","
",Hispanic/Latino,7,0,7
"
","
",Asian Non-Hispanic,6,0,6
"
","
",American Indian/Alaska Native Non-Hispanic,1,0,1
"
","
",Multiracial Non-Hispanic,3,1,2
"
",1 Year to < 2 Years,All Ethnicities,167,1,166
"
","
",White Non-Hispanic,109,1,108
"
","
",Black Non-Hispanic,34,0,34
"
","
",Hispanic/Latino,12,0,12
"
","
",Asian Non-Hispanic,9,0,9
"
","
",American Indian/Alaska Native Non-Hispanic,1,0,1
"
","
",Multiracial Non-Hispanic,2,0,2
"
",2 Years to < 3 Years,All Ethnicities,106,0,106
"
","
",White Non-Hispanic,69,0,69
"
","
",Black Non-Hispanic,30,0,30
"
","
",Hispanic/Latino,4,0,4
"
","
",Asian Non-Hispanic,3,0,3
"
",3 Years to < 5 Years,All Ethnicities,143,0,143
"
","
",White Non-Hispanic,96,0,96
"
","
",Black Non-Hispanic,25,0,25
"
","
",Hispanic/Latino,13,0,13
"
","
",Asian Non-Hispanic,7,0,7
"
","
",American Indian/Alaska Native Non-Hispanic,1,0,1
"
","
",Multiracial Non-Hispanic,1,0,1
"
",5 or More Years,All Ethnicities,49,0,49
"
","
",White Non-Hispanic,35,0,35
"
","
",Black Non-Hispanic,10,0,10
"
","
",Hispanic/Latino,2,0,2
"
","
","
","
","
","
"
"
","
",Asian Non-Hispanic,1,0,1
"
","
",Multiracial Non-Hispanic,1,0,1
NYRT-OP1 LiveOnNY,All Time,All Ethnicities,5861,98,5763
"
","
",White Non-Hispanic,1377,29,1348
"
","
",Black Non-Hispanic,2224,22,2202
"
","
",Hispanic/Latino,1388,41,1347
"
","
",Asian Non-Hispanic,835,6,829
"
","
",American Indian/Alaska Native Non-Hispanic,7,0,7
"
","
",Pacific Islander Non-Hispanic,2,0,2
"
","
",Multiracial Non-Hispanic,28,0,28
"
",< 30 Days,All Ethnicities,228,6,222
"
","
",White Non-Hispanic,64,0,64
"
","
",Black Non-Hispanic,76,0,76
"
","
",Hispanic/Latino,51,5,46
"
","
",Asian Non-Hispanic,34,1,33
"
","
",Multiracial Non-Hispanic,3,0,3
"
",30 to < 90 Days,All Ethnicities,342,13,329
"
","
",White Non-Hispanic,89,3,86
"
","
",Black Non-Hispanic,127,3,124
"
","
",Hispanic/Latino,84,5,79
"
","
",Asian Non-Hispanic,37,2,35
"
","
",American Indian/Alaska Native Non-Hispanic,1,0,1
"
","
",Pacific Islander Non-Hispanic,1,0,1
"
","
",Multiracial Non-Hispanic,3,0,3
"
",90 Days to < 6 Months,All Ethnicities,454,10,444
"
","
",White Non-Hispanic,126,2,124
"
","
",Black Non-Hispanic,165,4,161
"
","
",Hispanic/Latino,109,4,105
"
","
",Asian Non-Hispanic,53,0,53
"
","
",Multiracial Non-Hispanic,1,0,1
"
",6 Months to < 1 Year,All Ethnicities,879,13,866
"
","
",White Non-Hispanic,202,7,195
"
","
",Black Non-Hispanic,342,2,340
"
","
",Hispanic/Latino,197,4,193
"
","
",Asian Non-Hispanic,135,0,135
"
","
",American Indian/Alaska Native Non-Hispanic,1,0,1
"
","
",Multiracial Non-Hispanic,2,0,2
"
",1 Year to < 2 Years,All Ethnicities,1269,19,1250
"
","
",White Non-Hispanic,277,6,271
"
","
",Black Non-Hispanic,470,4,466
"
","
",Hispanic/Latino,301,8,293
"
","
","
","
","
","
"
"
","
",Asian Non-Hispanic,217,1,216
"
","
",Multiracial Non-Hispanic,4,0,4
"
",2 Years to < 3 Years,All Ethnicities,671,11,660
"
","
",White Non-Hispanic,166,4,162
"
","
",Black Non-Hispanic,241,2,239
"
","
",Hispanic/Latino,167,5,162
"
","
",Asian Non-Hispanic,91,0,91
"
","
",American Indian/Alaska Native Non-Hispanic,2,0,2
"
","
",Multiracial Non-Hispanic,4,0,4
"
",3 Years to < 5 Years,All Ethnicities,1110,15,1095
"
","
",White Non-Hispanic,243,3,240
"
","
",Black Non-Hispanic,435,4,431
"
","
",Hispanic/Latino,255,8,247
"
","
",Asian Non-Hispanic,166,0,166
"
","
",American Indian/Alaska Native Non-Hispanic,2,0,2
"
","
",Pacific Islander Non-Hispanic,1,0,1
"
","
",Multiracial Non-Hispanic,8,0,8
"
",5 or More Years,All Ethnicities,908,11,897
"
","
",White Non-Hispanic,210,4,206
"
","
",Black Non-Hispanic,368,3,365
"
","
",Hispanic/Latino,224,2,222
"
","
",Asian Non-Hispanic,102,2,100
"
","
",American Indian/Alaska Native Non-Hispanic,1,0,1
"
","
",Multiracial Non-Hispanic,3,0,3
NYWN-OP1 Upstate New York Transplant Services Inc,All Time,All Ethnicities,205,0,205
"
","
",White Non-Hispanic,108,0,108
"
","
",Black Non-Hispanic,65,0,65
"
","
",Hispanic/Latino,14,0,14
"
","
",Asian Non-Hispanic,16,0,16
"
","
",American Indian/Alaska Native Non-Hispanic,2,0,2
"
",< 30 Days,All Ethnicities,17,0,17
"
","
",White Non-Hispanic,12,0,12
"
","
",Black Non-Hispanic,3,0,3
"
","
",Hispanic/Latino,1,0,1
"
","
",American Indian/Alaska Native Non-Hispanic,1,0,1
"
",30 to < 90 Days,All Ethnicities,20,0,20
"
","
",White Non-Hispanic,6,0,6
"
","
",Black Non-Hispanic,9,0,9
"
","
",Asian Non-Hispanic,5,0,5
"
",90 Days to < 6 Months,All Ethnicities,18,0,18
"
","
",White Non-Hispanic,12,0,12
"
","
","
","
","
","
"
"
","
",Black Non-Hispanic,3,0,3
"
","
",Hispanic/Latino,3,0,3
"
",6 Months to < 1 Year,All Ethnicities,39,0,39
"
","
",White Non-Hispanic,22,0,22
"
","
",Black Non-Hispanic,5,0,5
"
","
",Hispanic/Latino,5,0,5
"
","
",Asian Non-Hispanic,7,0,7
"
",1 Year to < 2 Years,All Ethnicities,48,0,48
"
","
",White Non-Hispanic,27,0,27
"
","
",Black Non-Hispanic,19,0,19
"
","
",Asian Non-Hispanic,1,0,1
"
","
",American Indian/Alaska Native Non-Hispanic,1,0,1
"
",2 Years to < 3 Years,All Ethnicities,25,0,25
"
","
",White Non-Hispanic,9,0,9
"
","
",Black Non-Hispanic,11,0,11
"
","
",Hispanic/Latino,3,0,3
"
","
",Asian Non-Hispanic,2,0,2
"
",3 Years to < 5 Years,All Ethnicities,15,0,15
"
","
",White Non-Hispanic,9,0,9
"
","
",Black Non-Hispanic,5,0,5
"
","
",Hispanic/Latino,1,0,1
"
",5 or More Years,All Ethnicities,23,0,23
"
","
",White Non-Hispanic,11,0,11
"
","
",Black Non-Hispanic,10,0,10
"
","
",Hispanic/Latino,1,0,1
"
","
",Asian Non-Hispanic,1,0,1
OHLB-OP1 Lifebanc,All Time,All Ethnicities,826,7,819
"
","
",White Non-Hispanic,433,4,429
"
","
",Black Non-Hispanic,343,3,340
"
","
",Hispanic/Latino,29,0,29
"
","
",Asian Non-Hispanic,18,0,18
"
","
",American Indian/Alaska Native Non-Hispanic,1,0,1
"
","
",Pacific Islander Non-Hispanic,1,0,1
"
","
",Multiracial Non-Hispanic,1,0,1
"
",< 30 Days,All Ethnicities,44,2,42
"
","
",White Non-Hispanic,23,0,23
"
","
",Black Non-Hispanic,18,2,16
"
","
",Hispanic/Latino,1,0,1
"
","
",Asian Non-Hispanic,2,0,2
"
",30 to < 90 Days,All Ethnicities,58,0,58
"
","
",White Non-Hispanic,34,0,34
"
","
","
","
","
","
"
"
","
",Black Non-Hispanic,18,0,18
"
","
",Hispanic/Latino,3,0,3
"
","
",Asian Non-Hispanic,2,0,2
"
","
",Pacific Islander Non-Hispanic,1,0,1
"
",90 Days to < 6 Months,All Ethnicities,68,0,68
"
","
",White Non-Hispanic,38,0,38
"
","
",Black Non-Hispanic,24,0,24
"
","
",Hispanic/Latino,2,0,2
"
","
",Asian Non-Hispanic,3,0,3
"
","
",Multiracial Non-Hispanic,1,0,1
"
",6 Months to < 1 Year,All Ethnicities,98,1,97
"
","
",White Non-Hispanic,59,1,58
"
","
",Black Non-Hispanic,34,0,34
"
","
",Hispanic/Latino,2,0,2
"
","
",Asian Non-Hispanic,3,0,3
"
",1 Year to < 2 Years,All Ethnicities,153,0,153
"
","
",White Non-Hispanic,82,0,82
"
","
",Black Non-Hispanic,64,0,64
"
","
",Hispanic/Latino,5,0,5
"
","
",Asian Non-Hispanic,2,0,2
"
",2 Years to < 3 Years,All Ethnicities,115,2,113
"
","
",White Non-Hispanic,56,1,55
"
","
",Black Non-Hispanic,49,1,48
"
","
",Hispanic/Latino,7,0,7
"
","
",Asian Non-Hispanic,3,0,3
"
",3 Years to < 5 Years,All Ethnicities,155,1,154
"
","
",White Non-Hispanic,80,1,79
"
","
",Black Non-Hispanic,65,0,65
"
","
",Hispanic/Latino,6,0,6
"
","
",Asian Non-Hispanic,3,0,3
"
","
",American Indian/Alaska Native Non-Hispanic,1,0,1
"
",5 or More Years,All Ethnicities,135,1,134
"
","
",White Non-Hispanic,61,1,60
"
","
",Black Non-Hispanic,71,0,71
"
","
",Hispanic/Latino,3,0,3
OHLC-OP1 Life Connection of Ohio,All Time,All Ethnicities,61,0,61
"
","
",White Non-Hispanic,38,0,38
"
","
",Black Non-Hispanic,21,0,21
"
","
",Hispanic/Latino,1,0,1
"
","
",Asian Non-Hispanic,1,0,1
"
",< 30 Days,All Ethnicities,5,0,5
"
","
","
","
","
","
"
"
","
",White Non-Hispanic,3,0,3
"
","
",Black Non-Hispanic,2,0,2
"
",30 to < 90 Days,All Ethnicities,8,0,8
"
","
",White Non-Hispanic,3,0,3
"
","
",Black Non-Hispanic,5,0,5
"
",90 Days to < 6 Months,All Ethnicities,7,0,7
"
","
",White Non-Hispanic,6,0,6
"
","
",Black Non-Hispanic,1,0,1
"
",6 Months to < 1 Year,All Ethnicities,7,0,7
"
","
",White Non-Hispanic,2,0,2
"
","
",Black Non-Hispanic,5,0,5
"
",1 Year to < 2 Years,All Ethnicities,10,0,10
"
","
",White Non-Hispanic,7,0,7
"
","
",Black Non-Hispanic,2,0,2
"
","
",Hispanic/Latino,1,0,1
"
",2 Years to < 3 Years,All Ethnicities,3,0,3
"
","
",White Non-Hispanic,1,0,1
"
","
",Black Non-Hispanic,2,0,2
"
",3 Years to < 5 Years,All Ethnicities,8,0,8
"
","
",White Non-Hispanic,7,0,7
"
","
",Black Non-Hispanic,1,0,1
"
",5 or More Years,All Ethnicities,13,0,13
"
","
",White Non-Hispanic,9,0,9
"
","
",Black Non-Hispanic,3,0,3
"
","
",Asian Non-Hispanic,1,0,1
OHLP-OP1 Lifeline of Ohio,All Time,All Ethnicities,733,18,715
"
","
",White Non-Hispanic,479,10,469
"
","
",Black Non-Hispanic,214,6,208
"
","
",Hispanic/Latino,15,1,14
"
","
",Asian Non-Hispanic,21,0,21
"
","
",American Indian/Alaska Native Non-Hispanic,1,0,1
"
","
",Pacific Islander Non-Hispanic,1,0,1
"
","
",Multiracial Non-Hispanic,2,1,1
"
",< 30 Days,All Ethnicities,47,0,47
"
","
",White Non-Hispanic,31,0,31
"
","
",Black Non-Hispanic,14,0,14
"
","
",Hispanic/Latino,2,0,2
"
",30 to < 90 Days,All Ethnicities,61,3,58
"
","
",White Non-Hispanic,43,2,41
"
","
",Black Non-Hispanic,17,1,16
"
","
",Asian Non-Hispanic,1,0,1
"
","
","
","
","
","
"
"
",90 Days to < 6 Months,All Ethnicities,70,7,63
"
","
",White Non-Hispanic,51,5,46
"
","
",Black Non-Hispanic,16,2,14
"
","
",Asian Non-Hispanic,3,0,3
"
",6 Months to < 1 Year,All Ethnicities,163,4,159
"
","
",White Non-Hispanic,107,2,105
"
","
",Black Non-Hispanic,48,1,47
"
","
",Hispanic/Latino,5,1,4
"
","
",Asian Non-Hispanic,3,0,3
"
",1 Year to < 2 Years,All Ethnicities,220,2,218
"
","
",White Non-Hispanic,140,0,140
"
","
",Black Non-Hispanic,65,1,64
"
","
",Hispanic/Latino,4,0,4
"
","
",Asian Non-Hispanic,8,0,8
"
","
",American Indian/Alaska Native Non-Hispanic,1,0,1
"
","
",Multiracial Non-Hispanic,2,1,1
"
",2 Years to < 3 Years,All Ethnicities,109,1,108
"
","
",White Non-Hispanic,66,1,65
"
","
",Black Non-Hispanic,34,0,34
"
","
",Hispanic/Latino,3,0,3
"
","
",Asian Non-Hispanic,6,0,6
"
",3 Years to < 5 Years,All Ethnicities,50,0,50
"
","
",White Non-Hispanic,34,0,34
"
","
",Black Non-Hispanic,14,0,14
"
","
",Hispanic/Latino,1,0,1
"
","
",Pacific Islander Non-Hispanic,1,0,1
"
",5 or More Years,All Ethnicities,13,1,12
"
","
",White Non-Hispanic,7,0,7
"
","
",Black Non-Hispanic,6,1,5
OHOV-OP1 LifeCenter Organ Donor Network,All Time,All Ethnicities,442,19,423
"
","
",White Non-Hispanic,265,14,251
"
","
",Black Non-Hispanic,153,5,148
"
","
",Hispanic/Latino,11,0,11
"
","
",Asian Non-Hispanic,12,0,12
"
","
",Pacific Islander Non-Hispanic,1,0,1
"
",< 30 Days,All Ethnicities,32,4,28
"
","
",White Non-Hispanic,24,4,20
"
","
",Black Non-Hispanic,6,0,6
"
","
",Asian Non-Hispanic,2,0,2
"
",30 to < 90 Days,All Ethnicities,54,4,50
"
","
",White Non-Hispanic,35,3,32
"
","
","
","
","
","
"
"
","
",Black Non-Hispanic,17,1,16
"
","
",Hispanic/Latino,2,0,2
"
",90 Days to < 6 Months,All Ethnicities,55,4,51
"
","
",White Non-Hispanic,35,3,32
"
","
",Black Non-Hispanic,19,1,18
"
","
",Hispanic/Latino,1,0,1
"
",6 Months to < 1 Year,All Ethnicities,68,4,64
"
","
",White Non-Hispanic,44,3,41
"
","
",Black Non-Hispanic,21,1,20
"
","
",Hispanic/Latino,3,0,3
"
",1 Year to < 2 Years,All Ethnicities,96,2,94
"
","
",White Non-Hispanic,48,0,48
"
","
",Black Non-Hispanic,38,2,36
"
","
",Hispanic/Latino,3,0,3
"
","
",Asian Non-Hispanic,6,0,6
"
","
",Pacific Islander Non-Hispanic,1,0,1
"
",2 Years to < 3 Years,All Ethnicities,64,0,64
"
","
",White Non-Hispanic,39,0,39
"
","
",Black Non-Hispanic,23,0,23
"
","
",Hispanic/Latino,1,0,1
"
","
",Asian Non-Hispanic,1,0,1
"
",3 Years to < 5 Years,All Ethnicities,55,0,55
"
","
",White Non-Hispanic,33,0,33
"
","
",Black Non-Hispanic,19,0,19
"
","
",Hispanic/Latino,1,0,1
"
","
",Asian Non-Hispanic,2,0,2
"
",5 or More Years,All Ethnicities,18,1,17
"
","
",White Non-Hispanic,7,1,6
"
","
",Black Non-Hispanic,10,0,10
"
","
",Asian Non-Hispanic,1,0,1
OKOP-OP1 LifeShare Transplant Donor Services of Oklahoma,All Time,All Ethnicities,562,2,560
"
","
",White Non-Hispanic,290,0,290
"
","
",Black Non-Hispanic,111,0,111
"
","
",Hispanic/Latino,58,1,57
"
","
",Asian Non-Hispanic,20,0,20
"
","
",American Indian/Alaska Native Non-Hispanic,66,0,66
"
","
",Pacific Islander Non-Hispanic,5,0,5
"
","
",Multiracial Non-Hispanic,12,1,11
"
",< 30 Days,All Ethnicities,28,0,28
"
","
",White Non-Hispanic,15,0,15
"
","
",Black Non-Hispanic,7,0,7
"
","
","
","
","
","
"
"
","
",Hispanic/Latino,2,0,2
"
","
",Asian Non-Hispanic,1,0,1
"
","
",American Indian/Alaska Native Non-Hispanic,3,0,3
"
",30 to < 90 Days,All Ethnicities,51,0,51
"
","
",White Non-Hispanic,27,0,27
"
","
",Black Non-Hispanic,7,0,7
"
","
",Hispanic/Latino,2,0,2
"
","
",Asian Non-Hispanic,2,0,2
"
","
",American Indian/Alaska Native Non-Hispanic,10,0,10
"
","
",Pacific Islander Non-Hispanic,1,0,1
"
","
",Multiracial Non-Hispanic,2,0,2
"
",90 Days to < 6 Months,All Ethnicities,65,0,65
"
","
",White Non-Hispanic,32,0,32
"
","
",Black Non-Hispanic,11,0,11
"
","
",Hispanic/Latino,11,0,11
"
","
",Asian Non-Hispanic,3,0,3
"
","
",American Indian/Alaska Native Non-Hispanic,8,0,8
"
",6 Months to < 1 Year,All Ethnicities,106,0,106
"
","
",White Non-Hispanic,56,0,56
"
","
",Black Non-Hispanic,20,0,20
"
","
",Hispanic/Latino,9,0,9
"
","
",Asian Non-Hispanic,4,0,4
"
","
",American Indian/Alaska Native Non-Hispanic,15,0,15
"
","
",Pacific Islander Non-Hispanic,2,0,2
"
",1 Year to < 2 Years,All Ethnicities,148,1,147
"
","
",White Non-Hispanic,76,0,76
"
","
",Black Non-Hispanic,26,0,26
"
","
",Hispanic/Latino,18,1,17
"
","
",Asian Non-Hispanic,6,0,6
"
","
",American Indian/Alaska Native Non-Hispanic,16,0,16
"
","
",Multiracial Non-Hispanic,6,0,6
"
",2 Years to < 3 Years,All Ethnicities,84,1,83
"
","
",White Non-Hispanic,46,0,46
"
","
",Black Non-Hispanic,18,0,18
"
","
",Hispanic/Latino,10,0,10
"
","
",Asian Non-Hispanic,1,0,1
"
","
",American Indian/Alaska Native Non-Hispanic,6,0,6
"
","
",Multiracial Non-Hispanic,3,1,2
"
",3 Years to < 5 Years,All Ethnicities,64,0,64
"
","
",White Non-Hispanic,33,0,33
"
","
",Black Non-Hispanic,16,0,16
"
","
","
","
","
","
"
"
","
",Hispanic/Latino,4,0,4
"
","
",Asian Non-Hispanic,2,0,2
"
","
",American Indian/Alaska Native Non-Hispanic,6,0,6
"
","
",Pacific Islander Non-Hispanic,2,0,2
"
","
",Multiracial Non-Hispanic,1,0,1
"
",5 or More Years,All Ethnicities,16,0,16
"
","
",White Non-Hispanic,5,0,5
"
","
",Black Non-Hispanic,6,0,6
"
","
",Hispanic/Latino,2,0,2
"
","
",Asian Non-Hispanic,1,0,1
"
","
",American Indian/Alaska Native Non-Hispanic,2,0,2
ORUO-IO1 Cascade Life Alliance,All Time,All Ethnicities,753,2,751
"
","
",White Non-Hispanic,440,0,440
"
","
",Black Non-Hispanic,98,0,98
"
","
",Hispanic/Latino,121,2,119
"
","
",Asian Non-Hispanic,54,0,54
"
","
",American Indian/Alaska Native Non-Hispanic,7,0,7
"
","
",Pacific Islander Non-Hispanic,20,0,20
"
","
",Multiracial Non-Hispanic,13,0,13
"
",< 30 Days,All Ethnicities,43,0,43
"
","
",White Non-Hispanic,29,0,29
"
","
",Black Non-Hispanic,3,0,3
"
","
",Hispanic/Latino,6,0,6
"
","
",Asian Non-Hispanic,2,0,2
"
","
",American Indian/Alaska Native Non-Hispanic,1,0,1
"
","
",Multiracial Non-Hispanic,2,0,2
"
",30 to < 90 Days,All Ethnicities,55,1,54
"
","
",White Non-Hispanic,33,0,33
"
","
",Black Non-Hispanic,8,0,8
"
","
",Hispanic/Latino,7,1,6
"
","
",Asian Non-Hispanic,4,0,4
"
","
",Pacific Islander Non-Hispanic,1,0,1
"
","
",Multiracial Non-Hispanic,2,0,2
"
",90 Days to < 6 Months,All Ethnicities,75,0,75
"
","
",White Non-Hispanic,49,0,49
"
","
",Black Non-Hispanic,5,0,5
"
","
",Hispanic/Latino,10,0,10
"
","
",Asian Non-Hispanic,6,0,6
"
","
",Pacific Islander Non-Hispanic,2,0,2
"
","
",Multiracial Non-Hispanic,3,0,3
"
",6 Months to < 1 Year,All Ethnicities,136,1,135
"
","
","
","
","
","
"
"
","
",White Non-Hispanic,77,0,77
"
","
",Black Non-Hispanic,20,0,20
"
","
",Hispanic/Latino,23,1,22
"
","
",Asian Non-Hispanic,12,0,12
"
","
",Pacific Islander Non-Hispanic,2,0,2
"
","
",Multiracial Non-Hispanic,2,0,2
"
",1 Year to < 2 Years,All Ethnicities,191,0,191
"
","
",White Non-Hispanic,114,0,114
"
","
",Black Non-Hispanic,21,0,21
"
","
",Hispanic/Latino,30,0,30
"
","
",Asian Non-Hispanic,14,0,14
"
","
",American Indian/Alaska Native Non-Hispanic,2,0,2
"
","
",Pacific Islander Non-Hispanic,7,0,7
"
","
",Multiracial Non-Hispanic,3,0,3
"
",2 Years to < 3 Years,All Ethnicities,120,0,120
"
","
",White Non-Hispanic,71,0,71
"
","
",Black Non-Hispanic,16,0,16
"
","
",Hispanic/Latino,18,0,18
"
","
",Asian Non-Hispanic,9,0,9
"
","
",American Indian/Alaska Native Non-Hispanic,2,0,2
"
","
",Pacific Islander Non-Hispanic,4,0,4
"
",3 Years to < 5 Years,All Ethnicities,94,0,94
"
","
",White Non-Hispanic,47,0,47
"
","
",Black Non-Hispanic,12,0,12
"
","
",Hispanic/Latino,24,0,24
"
","
",Asian Non-Hispanic,5,0,5
"
","
",American Indian/Alaska Native Non-Hispanic,1,0,1
"
","
",Pacific Islander Non-Hispanic,4,0,4
"
","
",Multiracial Non-Hispanic,1,0,1
"
",5 or More Years,All Ethnicities,39,0,39
"
","
",White Non-Hispanic,20,0,20
"
","
",Black Non-Hispanic,13,0,13
"
","
",Hispanic/Latino,3,0,3
"
","
",Asian Non-Hispanic,2,0,2
"
","
",American Indian/Alaska Native Non-Hispanic,1,0,1
PADV-OP1 Gift of Life Donor Program,All Time,All Ethnicities,4498,69,4429
"
","
",White Non-Hispanic,1855,42,1813
"
","
",Black Non-Hispanic,1915,9,1906
"
","
",Hispanic/Latino,409,11,398
"
","
",Asian Non-Hispanic,285,7,278
"
","
",American Indian/Alaska Native Non-Hispanic,4,0,4
"
","
","
","
","
","
"
"
","
",Pacific Islander Non-Hispanic,5,0,5
"
","
",Multiracial Non-Hispanic,25,0,25
"
",< 30 Days,All Ethnicities,115,3,112
"
","
",White Non-Hispanic,48,2,46
"
","
",Black Non-Hispanic,51,0,51
"
","
",Hispanic/Latino,9,1,8
"
","
",Asian Non-Hispanic,7,0,7
"
",30 to < 90 Days,All Ethnicities,301,10,291
"
","
",White Non-Hispanic,149,6,143
"
","
",Black Non-Hispanic,105,0,105
"
","
",Hispanic/Latino,25,2,23
"
","
",Asian Non-Hispanic,17,2,15
"
","
",Pacific Islander Non-Hispanic,1,0,1
"
","
",Multiracial Non-Hispanic,4,0,4
"
",90 Days to < 6 Months,All Ethnicities,313,9,304
"
","
",White Non-Hispanic,138,6,132
"
","
",Black Non-Hispanic,115,1,114
"
","
",Hispanic/Latino,33,1,32
"
","
",Asian Non-Hispanic,23,1,22
"
","
",American Indian/Alaska Native Non-Hispanic,1,0,1
"
","
",Multiracial Non-Hispanic,3,0,3
"
",6 Months to < 1 Year,All Ethnicities,605,15,590
"
","
",White Non-Hispanic,296,11,285
"
","
",Black Non-Hispanic,218,1,217
"
","
",Hispanic/Latino,63,2,61
"
","
",Asian Non-Hispanic,25,1,24
"
","
",American Indian/Alaska Native Non-Hispanic,1,0,1
"
","
",Multiracial Non-Hispanic,2,0,2
"
",1 Year to < 2 Years,All Ethnicities,1024,15,1009
"
","
",White Non-Hispanic,427,8,419
"
","
",Black Non-Hispanic,431,3,428
"
","
",Hispanic/Latino,85,3,82
"
","
",Asian Non-Hispanic,79,1,78
"
","
",American Indian/Alaska Native Non-Hispanic,1,0,1
"
","
",Pacific Islander Non-Hispanic,1,0,1
"
",2 Years to < 3 Years,All Ethnicities,633,6,627
"
","
",White Non-Hispanic,264,2,262
"
","
",Black Non-Hispanic,248,1,247
"
","
",Hispanic/Latino,77,2,75
"
","
",Asian Non-Hispanic,37,1,36
"
","
",Pacific Islander Non-Hispanic,2,0,2
"
","
","
","
","
","
"
"
","
",Multiracial Non-Hispanic,5,0,5
"
",3 Years to < 5 Years,All Ethnicities,909,6,903
"
","
",White Non-Hispanic,342,3,339
"
","
",Black Non-Hispanic,418,3,415
"
","
",Hispanic/Latino,79,0,79
"
","
",Asian Non-Hispanic,63,0,63
"
","
",American Indian/Alaska Native Non-Hispanic,1,0,1
"
","
",Multiracial Non-Hispanic,6,0,6
"
",5 or More Years,All Ethnicities,598,5,593
"
","
",White Non-Hispanic,191,4,187
"
","
",Black Non-Hispanic,329,0,329
"
","
",Hispanic/Latino,38,0,38
"
","
",Asian Non-Hispanic,34,1,33
"
","
",Pacific Islander Non-Hispanic,1,0,1
"
","
",Multiracial Non-Hispanic,5,0,5
PATF-OP1 Center for Organ Recovery and Education,All Time,All Ethnicities,1770,6,1764
"
","
",White Non-Hispanic,1159,5,1154
"
","
",Black Non-Hispanic,530,1,529
"
","
",Hispanic/Latino,42,0,42
"
","
",Asian Non-Hispanic,22,0,22
"
","
",American Indian/Alaska Native Non-Hispanic,7,0,7
"
","
",Pacific Islander Non-Hispanic,4,0,4
"
","
",Multiracial Non-Hispanic,6,0,6
"
",< 30 Days,All Ethnicities,84,0,84
"
","
",White Non-Hispanic,55,0,55
"
","
",Black Non-Hispanic,26,0,26
"
","
",Hispanic/Latino,1,0,1
"
","
",Asian Non-Hispanic,1,0,1
"
","
",Pacific Islander Non-Hispanic,1,0,1
"
",30 to < 90 Days,All Ethnicities,112,2,110
"
","
",White Non-Hispanic,75,2,73
"
","
",Black Non-Hispanic,30,0,30
"
","
",Hispanic/Latino,6,0,6
"
","
",Asian Non-Hispanic,1,0,1
"
",90 Days to < 6 Months,All Ethnicities,188,0,188
"
","
",White Non-Hispanic,127,0,127
"
","
",Black Non-Hispanic,56,0,56
"
","
",Hispanic/Latino,2,0,2
"
","
",Asian Non-Hispanic,3,0,3
"
",6 Months to < 1 Year,All Ethnicities,306,2,304
"
","
",White Non-Hispanic,209,1,208
"
","
","
","
","
","
"
"
","
",Black Non-Hispanic,87,1,86
"
","
",Hispanic/Latino,3,0,3
"
","
",Asian Non-Hispanic,4,0,4
"
","
",American Indian/Alaska Native Non-Hispanic,2,0,2
"
","
",Multiracial Non-Hispanic,1,0,1
"
",1 Year to < 2 Years,All Ethnicities,413,1,412
"
","
",White Non-Hispanic,261,1,260
"
","
",Black Non-Hispanic,130,0,130
"
","
",Hispanic/Latino,12,0,12
"
","
",Asian Non-Hispanic,4,0,4
"
","
",American Indian/Alaska Native Non-Hispanic,3,0,3
"
","
",Pacific Islander Non-Hispanic,2,0,2
"
","
",Multiracial Non-Hispanic,1,0,1
"
",2 Years to < 3 Years,All Ethnicities,213,0,213
"
","
",White Non-Hispanic,152,0,152
"
","
",Black Non-Hispanic,51,0,51
"
","
",Hispanic/Latino,8,0,8
"
","
",Asian Non-Hispanic,1,0,1
"
","
",American Indian/Alaska Native Non-Hispanic,1,0,1
"
",3 Years to < 5 Years,All Ethnicities,273,1,272
"
","
",White Non-Hispanic,184,1,183
"
","
",Black Non-Hispanic,73,0,73
"
","
",Hispanic/Latino,7,0,7
"
","
",Asian Non-Hispanic,6,0,6
"
","
",American Indian/Alaska Native Non-Hispanic,1,0,1
"
","
",Multiracial Non-Hispanic,2,0,2
"
",5 or More Years,All Ethnicities,181,0,181
"
","
",White Non-Hispanic,96,0,96
"
","
",Black Non-Hispanic,77,0,77
"
","
",Hispanic/Latino,3,0,3
"
","
",Asian Non-Hispanic,2,0,2
"
","
",Pacific Islander Non-Hispanic,1,0,1
"
","
",Multiracial Non-Hispanic,2,0,2
PRLL-OP1 LifeLink of Puerto Rico,All Time,All Ethnicities,312,0,312
"
","
",White Non-Hispanic,1,0,1
"
","
",Hispanic/Latino,311,0,311
"
",< 30 Days,All Ethnicities,13,0,13
"
","
",Hispanic/Latino,13,0,13
"
",30 to < 90 Days,All Ethnicities,29,0,29
"
","
",White Non-Hispanic,1,0,1
"
","
",Hispanic/Latino,28,0,28
"
","
","
","
","
","
"
"
",90 Days to < 6 Months,All Ethnicities,32,0,32
"
","
",Hispanic/Latino,32,0,32
"
",6 Months to < 1 Year,All Ethnicities,58,0,58
"
","
",Hispanic/Latino,58,0,58
"
",1 Year to < 2 Years,All Ethnicities,64,0,64
"
","
",Hispanic/Latino,64,0,64
"
",2 Years to < 3 Years,All Ethnicities,30,0,30
"
","
",Hispanic/Latino,30,0,30
"
",3 Years to < 5 Years,All Ethnicities,61,0,61
"
","
",Hispanic/Latino,61,0,61
"
",5 or More Years,All Ethnicities,25,0,25
"
","
",Hispanic/Latino,25,0,25
SCOP-OP1 We Are Sharing Hope SC,All Time,All Ethnicities,1618,1,1617
"
","
",White Non-Hispanic,475,0,475
"
","
",Black Non-Hispanic,1046,0,1046
"
","
",Hispanic/Latino,53,1,52
"
","
",Asian Non-Hispanic,29,0,29
"
","
",American Indian/Alaska Native Non-Hispanic,9,0,9
"
","
",Pacific Islander Non-Hispanic,5,0,5
"
","
",Multiracial Non-Hispanic,1,0,1
"
",< 30 Days,All Ethnicities,83,0,83
"
","
",White Non-Hispanic,24,0,24
"
","
",Black Non-Hispanic,53,0,53
"
","
",Hispanic/Latino,3,0,3
"
","
",Asian Non-Hispanic,1,0,1
"
","
",American Indian/Alaska Native Non-Hispanic,1,0,1
"
","
",Pacific Islander Non-Hispanic,1,0,1
"
",30 to < 90 Days,All Ethnicities,141,0,141
"
","
",White Non-Hispanic,43,0,43
"
","
",Black Non-Hispanic,85,0,85
"
","
",Hispanic/Latino,7,0,7
"
","
",Asian Non-Hispanic,5,0,5
"
","
",American Indian/Alaska Native Non-Hispanic,1,0,1
"
",90 Days to < 6 Months,All Ethnicities,206,0,206
"
","
",White Non-Hispanic,66,0,66
"
","
",Black Non-Hispanic,123,0,123
"
","
",Hispanic/Latino,13,0,13
"
","
",Asian Non-Hispanic,2,0,2
"
","
",American Indian/Alaska Native Non-Hispanic,2,0,2
"
",6 Months to < 1 Year,All Ethnicities,318,0,318
"
","
",White Non-Hispanic,106,0,106
"
","
","
","
","
","
"
"
","
",Black Non-Hispanic,194,0,194
"
","
",Hispanic/Latino,12,0,12
"
","
",Asian Non-Hispanic,3,0,3
"
","
",American Indian/Alaska Native Non-Hispanic,2,0,2
"
","
",Pacific Islander Non-Hispanic,1,0,1
"
",1 Year to < 2 Years,All Ethnicities,369,1,368
"
","
",White Non-Hispanic,107,0,107
"
","
",Black Non-Hispanic,249,0,249
"
","
",Hispanic/Latino,8,1,7
"
","
",Asian Non-Hispanic,4,0,4
"
","
",American Indian/Alaska Native Non-Hispanic,1,0,1
"
",2 Years to < 3 Years,All Ethnicities,236,0,236
"
","
",White Non-Hispanic,66,0,66
"
","
",Black Non-Hispanic,160,0,160
"
","
",Hispanic/Latino,3,0,3
"
","
",Asian Non-Hispanic,4,0,4
"
","
",Pacific Islander Non-Hispanic,2,0,2
"
","
",Multiracial Non-Hispanic,1,0,1
"
",3 Years to < 5 Years,All Ethnicities,171,0,171
"
","
",White Non-Hispanic,43,0,43
"
","
",Black Non-Hispanic,115,0,115
"
","
",Hispanic/Latino,3,0,3
"
","
",Asian Non-Hispanic,7,0,7
"
","
",American Indian/Alaska Native Non-Hispanic,2,0,2
"
","
",Pacific Islander Non-Hispanic,1,0,1
"
",5 or More Years,All Ethnicities,94,0,94
"
","
",White Non-Hispanic,20,0,20
"
","
",Black Non-Hispanic,67,0,67
"
","
",Hispanic/Latino,4,0,4
"
","
",Asian Non-Hispanic,3,0,3
TNDS-OP1 Tennessee Donor Services,All Time,All Ethnicities,2127,6,2121
"
","
",White Non-Hispanic,1110,2,1108
"
","
",Black Non-Hispanic,828,2,826
"
","
",Hispanic/Latino,88,0,88
"
","
",Asian Non-Hispanic,49,1,48
"
","
",American Indian/Alaska Native Non-Hispanic,2,0,2
"
","
",Pacific Islander Non-Hispanic,2,0,2
"
","
",Multiracial Non-Hispanic,48,1,47
"
",< 30 Days,All Ethnicities,107,1,106
"
","
",White Non-Hispanic,53,0,53
"
","
",Black Non-Hispanic,45,0,45
"
","
","
","
","
","
"
"
","
",Hispanic/Latino,4,0,4
"
","
",Asian Non-Hispanic,1,0,1
"
","
",Multiracial Non-Hispanic,4,1,3
"
",30 to < 90 Days,All Ethnicities,168,0,168
"
","
",White Non-Hispanic,88,0,88
"
","
",Black Non-Hispanic,67,0,67
"
","
",Hispanic/Latino,4,0,4
"
","
",Asian Non-Hispanic,5,0,5
"
","
",Multiracial Non-Hispanic,4,0,4
"
",90 Days to < 6 Months,All Ethnicities,207,2,205
"
","
",White Non-Hispanic,116,1,115
"
","
",Black Non-Hispanic,71,1,70
"
","
",Hispanic/Latino,8,0,8
"
","
",Asian Non-Hispanic,8,0,8
"
","
",Multiracial Non-Hispanic,4,0,4
"
",6 Months to < 1 Year,All Ethnicities,401,2,399
"
","
",White Non-Hispanic,218,1,217
"
","
",Black Non-Hispanic,144,0,144
"
","
",Hispanic/Latino,16,0,16
"
","
",Asian Non-Hispanic,12,1,11
"
","
",Multiracial Non-Hispanic,11,0,11
"
",1 Year to < 2 Years,All Ethnicities,507,1,506
"
","
",White Non-Hispanic,238,0,238
"
","
",Black Non-Hispanic,220,1,219
"
","
",Hispanic/Latino,24,0,24
"
","
",Asian Non-Hispanic,11,0,11
"
","
",Pacific Islander Non-Hispanic,1,0,1
"
","
",Multiracial Non-Hispanic,13,0,13
"
",2 Years to < 3 Years,All Ethnicities,333,0,333
"
","
",White Non-Hispanic,169,0,169
"
","
",Black Non-Hispanic,131,0,131
"
","
",Hispanic/Latino,16,0,16
"
","
",Asian Non-Hispanic,8,0,8
"
","
",Pacific Islander Non-Hispanic,1,0,1
"
","
",Multiracial Non-Hispanic,8,0,8
"
",3 Years to < 5 Years,All Ethnicities,279,0,279
"
","
",White Non-Hispanic,159,0,159
"
","
",Black Non-Hispanic,102,0,102
"
","
",Hispanic/Latino,13,0,13
"
","
",Asian Non-Hispanic,3,0,3
"
","
",American Indian/Alaska Native Non-Hispanic,1,0,1
"
","
","
","
","
","
"
"
","
",Multiracial Non-Hispanic,1,0,1
"
",5 or More Years,All Ethnicities,125,0,125
"
","
",White Non-Hispanic,69,0,69
"
","
",Black Non-Hispanic,48,0,48
"
","
",Hispanic/Latino,3,0,3
"
","
",Asian Non-Hispanic,1,0,1
"
","
",American Indian/Alaska Native Non-Hispanic,1,0,1
"
","
",Multiracial Non-Hispanic,3,0,3
TNMS-OP1 Mid-South Transplant Foundation,All Time,All Ethnicities,681,6,675
"
","
",White Non-Hispanic,116,2,114
"
","
",Black Non-Hispanic,539,4,535
"
","
",Hispanic/Latino,10,0,10
"
","
",Asian Non-Hispanic,14,0,14
"
","
",American Indian/Alaska Native Non-Hispanic,1,0,1
"
","
",Multiracial Non-Hispanic,1,0,1
"
",< 30 Days,All Ethnicities,30,0,30
"
","
",White Non-Hispanic,5,0,5
"
","
",Black Non-Hispanic,25,0,25
"
",30 to < 90 Days,All Ethnicities,59,2,57
"
","
",White Non-Hispanic,17,1,16
"
","
",Black Non-Hispanic,41,1,40
"
","
",Asian Non-Hispanic,1,0,1
"
",90 Days to < 6 Months,All Ethnicities,55,1,54
"
","
",White Non-Hispanic,6,1,5
"
","
",Black Non-Hispanic,45,0,45
"
","
",Hispanic/Latino,2,0,2
"
","
",Asian Non-Hispanic,1,0,1
"
","
",Multiracial Non-Hispanic,1,0,1
"
",6 Months to < 1 Year,All Ethnicities,149,0,149
"
","
",White Non-Hispanic,25,0,25
"
","
",Black Non-Hispanic,120,0,120
"
","
",Hispanic/Latino,1,0,1
"
","
",Asian Non-Hispanic,3,0,3
"
",1 Year to < 2 Years,All Ethnicities,125,2,123
"
","
",White Non-Hispanic,28,0,28
"
","
",Black Non-Hispanic,89,2,87
"
","
",Hispanic/Latino,2,0,2
"
","
",Asian Non-Hispanic,6,0,6
"
",2 Years to < 3 Years,All Ethnicities,96,1,95
"
","
",White Non-Hispanic,13,0,13
"
","
",Black Non-Hispanic,80,1,79
"
","
","
","
","
","
"
"
","
",Hispanic/Latino,2,0,2
"
","
",Asian Non-Hispanic,1,0,1
"
",3 Years to < 5 Years,All Ethnicities,116,0,116
"
","
",White Non-Hispanic,16,0,16
"
","
",Black Non-Hispanic,94,0,94
"
","
",Hispanic/Latino,3,0,3
"
","
",Asian Non-Hispanic,2,0,2
"
","
",American Indian/Alaska Native Non-Hispanic,1,0,1
"
",5 or More Years,All Ethnicities,51,0,51
"
","
",White Non-Hispanic,6,0,6
"
","
",Black Non-Hispanic,45,0,45
TXGC-OP1 LifeGift Organ Donation Center,All Time,All Ethnicities,3685,41,3644
"
","
",White Non-Hispanic,961,17,944
"
","
",Black Non-Hispanic,1339,8,1331
"
","
",Hispanic/Latino,1097,14,1083
"
","
",Asian Non-Hispanic,250,2,248
"
","
",American Indian/Alaska Native Non-Hispanic,20,0,20
"
","
",Pacific Islander Non-Hispanic,6,0,6
"
","
",Multiracial Non-Hispanic,12,0,12
"
",< 30 Days,All Ethnicities,151,7,144
"
","
",White Non-Hispanic,46,2,44
"
","
",Black Non-Hispanic,45,2,43
"
","
",Hispanic/Latino,44,3,41
"
","
",Asian Non-Hispanic,12,0,12
"
","
",American Indian/Alaska Native Non-Hispanic,1,0,1
"
","
",Multiracial Non-Hispanic,3,0,3
"
",30 to < 90 Days,All Ethnicities,258,10,248
"
","
",White Non-Hispanic,96,5,91
"
","
",Black Non-Hispanic,69,0,69
"
","
",Hispanic/Latino,73,3,70
"
","
",Asian Non-Hispanic,17,2,15
"
","
",American Indian/Alaska Native Non-Hispanic,1,0,1
"
","
",Pacific Islander Non-Hispanic,1,0,1
"
","
",Multiracial Non-Hispanic,1,0,1
"
",90 Days to < 6 Months,All Ethnicities,252,5,247
"
","
",White Non-Hispanic,80,2,78
"
","
",Black Non-Hispanic,82,1,81
"
","
",Hispanic/Latino,75,2,73
"
","
",Asian Non-Hispanic,11,0,11
"
","
",American Indian/Alaska Native Non-Hispanic,1,0,1
"
","
",Multiracial Non-Hispanic,3,0,3
"
","
","
","
","
","
"
"
",6 Months to < 1 Year,All Ethnicities,472,7,465
"
","
",White Non-Hispanic,145,1,144
"
","
",Black Non-Hispanic,171,3,168
"
","
",Hispanic/Latino,119,3,116
"
","
",Asian Non-Hispanic,35,0,35
"
","
",American Indian/Alaska Native Non-Hispanic,2,0,2
"
",1 Year to < 2 Years,All Ethnicities,803,6,797
"
","
",White Non-Hispanic,220,3,217
"
","
",Black Non-Hispanic,287,2,285
"
","
",Hispanic/Latino,232,1,231
"
","
",Asian Non-Hispanic,61,0,61
"
","
",American Indian/Alaska Native Non-Hispanic,2,0,2
"
","
",Multiracial Non-Hispanic,1,0,1
"
",2 Years to < 3 Years,All Ethnicities,497,2,495
"
","
",White Non-Hispanic,125,2,123
"
","
",Black Non-Hispanic,179,0,179
"
","
",Hispanic/Latino,152,0,152
"
","
",Asian Non-Hispanic,34,0,34
"
","
",American Indian/Alaska Native Non-Hispanic,3,0,3
"
","
",Pacific Islander Non-Hispanic,2,0,2
"
","
",Multiracial Non-Hispanic,2,0,2
"
",3 Years to < 5 Years,All Ethnicities,810,2,808
"
","
",White Non-Hispanic,162,2,160
"
","
",Black Non-Hispanic,308,0,308
"
","
",Hispanic/Latino,272,0,272
"
","
",Asian Non-Hispanic,57,0,57
"
","
",American Indian/Alaska Native Non-Hispanic,6,0,6
"
","
",Pacific Islander Non-Hispanic,3,0,3
"
","
",Multiracial Non-Hispanic,2,0,2
"
",5 or More Years,All Ethnicities,442,2,440
"
","
",White Non-Hispanic,87,0,87
"
","
",Black Non-Hispanic,198,0,198
"
","
",Hispanic/Latino,130,2,128
"
","
",Asian Non-Hispanic,23,0,23
"
","
",American Indian/Alaska Native Non-Hispanic,4,0,4
TXSA-OP1 Texas Organ Sharing Alliance,All Time,All Ethnicities,2706,10,2696
"
","
",White Non-Hispanic,460,3,457
"
","
",Black Non-Hispanic,283,0,283
"
","
",Hispanic/Latino,1880,6,1874
"
","
",Asian Non-Hispanic,70,1,69
"
","
",American Indian/Alaska Native Non-Hispanic,3,0,3
"
","
","
","
","
","
"
"
","
",Pacific Islander Non-Hispanic,5,0,5
"
","
",Multiracial Non-Hispanic,5,0,5
"
",< 30 Days,All Ethnicities,97,3,94
"
","
",White Non-Hispanic,21,1,20
"
","
",Black Non-Hispanic,16,0,16
"
","
",Hispanic/Latino,58,1,57
"
","
",Asian Non-Hispanic,2,1,1
"
",30 to < 90 Days,All Ethnicities,207,4,203
"
","
",White Non-Hispanic,45,1,44
"
","
",Black Non-Hispanic,19,0,19
"
","
",Hispanic/Latino,133,3,130
"
","
",Asian Non-Hispanic,7,0,7
"
","
",American Indian/Alaska Native Non-Hispanic,1,0,1
"
","
",Pacific Islander Non-Hispanic,1,0,1
"
","
",Multiracial Non-Hispanic,1,0,1
"
",90 Days to < 6 Months,All Ethnicities,263,1,262
"
","
",White Non-Hispanic,47,0,47
"
","
",Black Non-Hispanic,35,0,35
"
","
",Hispanic/Latino,174,1,173
"
","
",Asian Non-Hispanic,5,0,5
"
","
",Pacific Islander Non-Hispanic,1,0,1
"
","
",Multiracial Non-Hispanic,1,0,1
"
",6 Months to < 1 Year,All Ethnicities,551,0,551
"
","
",White Non-Hispanic,88,0,88
"
","
",Black Non-Hispanic,61,0,61
"
","
",Hispanic/Latino,383,0,383
"
","
",Asian Non-Hispanic,15,0,15
"
","
",American Indian/Alaska Native Non-Hispanic,2,0,2
"
","
",Pacific Islander Non-Hispanic,1,0,1
"
","
",Multiracial Non-Hispanic,1,0,1
"
",1 Year to < 2 Years,All Ethnicities,688,1,687
"
","
",White Non-Hispanic,127,0,127
"
","
",Black Non-Hispanic,66,0,66
"
","
",Hispanic/Latino,475,1,474
"
","
",Asian Non-Hispanic,18,0,18
"
","
",Pacific Islander Non-Hispanic,1,0,1
"
","
",Multiracial Non-Hispanic,1,0,1
"
",2 Years to < 3 Years,All Ethnicities,359,0,359
"
","
",White Non-Hispanic,51,0,51
"
","
",Black Non-Hispanic,37,0,37
"
","
",Hispanic/Latino,261,0,261
"
","
","
","
","
","
"
"
","
",Asian Non-Hispanic,9,0,9
"
","
",Multiracial Non-Hispanic,1,0,1
"
",3 Years to < 5 Years,All Ethnicities,413,1,412
"
","
",White Non-Hispanic,63,1,62
"
","
",Black Non-Hispanic,32,0,32
"
","
",Hispanic/Latino,306,0,306
"
","
",Asian Non-Hispanic,11,0,11
"
","
",Pacific Islander Non-Hispanic,1,0,1
"
",5 or More Years,All Ethnicities,128,0,128
"
","
",White Non-Hispanic,18,0,18
"
","
",Black Non-Hispanic,17,0,17
"
","
",Hispanic/Latino,90,0,90
"
","
",Asian Non-Hispanic,3,0,3
TXSB-OP1 Southwest Transplant Alliance,All Time,All Ethnicities,3312,18,3294
"
","
",White Non-Hispanic,799,6,793
"
","
",Black Non-Hispanic,1051,2,1049
"
","
",Hispanic/Latino,1256,8,1248
"
","
",Asian Non-Hispanic,176,1,175
"
","
",American Indian/Alaska Native Non-Hispanic,11,0,11
"
","
",Pacific Islander Non-Hispanic,12,0,12
"
","
",Multiracial Non-Hispanic,7,1,6
"
",< 30 Days,All Ethnicities,179,1,178
"
","
",White Non-Hispanic,33,1,32
"
","
",Black Non-Hispanic,56,0,56
"
","
",Hispanic/Latino,84,0,84
"
","
",Asian Non-Hispanic,6,0,6
"
",30 to < 90 Days,All Ethnicities,242,2,240
"
","
",White Non-Hispanic,71,0,71
"
","
",Black Non-Hispanic,77,1,76
"
","
",Hispanic/Latino,81,1,80
"
","
",Asian Non-Hispanic,12,0,12
"
","
",Pacific Islander Non-Hispanic,1,0,1
"
",90 Days to < 6 Months,All Ethnicities,281,3,278
"
","
",White Non-Hispanic,71,1,70
"
","
",Black Non-Hispanic,85,0,85
"
","
",Hispanic/Latino,104,2,102
"
","
",Asian Non-Hispanic,16,0,16
"
","
",American Indian/Alaska Native Non-Hispanic,2,0,2
"
","
",Pacific Islander Non-Hispanic,1,0,1
"
","
",Multiracial Non-Hispanic,2,0,2
"
",6 Months to < 1 Year,All Ethnicities,576,3,573
"
","
","
","
","
","
"
"
","
",White Non-Hispanic,160,1,159
"
","
",Black Non-Hispanic,165,0,165
"
","
",Hispanic/Latino,206,2,204
"
","
",Asian Non-Hispanic,42,0,42
"
","
",American Indian/Alaska Native Non-Hispanic,3,0,3
"
",1 Year to < 2 Years,All Ethnicities,879,5,874
"
","
",White Non-Hispanic,220,1,219
"
","
",Black Non-Hispanic,257,1,256
"
","
",Hispanic/Latino,346,2,344
"
","
",Asian Non-Hispanic,52,1,51
"
","
",American Indian/Alaska Native Non-Hispanic,1,0,1
"
","
",Pacific Islander Non-Hispanic,2,0,2
"
","
",Multiracial Non-Hispanic,1,0,1
"
",2 Years to < 3 Years,All Ethnicities,448,3,445
"
","
",White Non-Hispanic,94,1,93
"
","
",Black Non-Hispanic,138,0,138
"
","
",Hispanic/Latino,187,1,186
"
","
",Asian Non-Hispanic,19,0,19
"
","
",American Indian/Alaska Native Non-Hispanic,3,0,3
"
","
",Pacific Islander Non-Hispanic,4,0,4
"
","
",Multiracial Non-Hispanic,3,1,2
"
",3 Years to < 5 Years,All Ethnicities,455,1,454
"
","
",White Non-Hispanic,83,1,82
"
","
",Black Non-Hispanic,154,0,154
"
","
",Hispanic/Latino,190,0,190
"
","
",Asian Non-Hispanic,22,0,22
"
","
",American Indian/Alaska Native Non-Hispanic,1,0,1
"
","
",Pacific Islander Non-Hispanic,4,0,4
"
","
",Multiracial Non-Hispanic,1,0,1
"
",5 or More Years,All Ethnicities,252,0,252
"
","
",White Non-Hispanic,67,0,67
"
","
",Black Non-Hispanic,119,0,119
"
","
",Hispanic/Latino,58,0,58
"
","
",Asian Non-Hispanic,7,0,7
"
","
",American Indian/Alaska Native Non-Hispanic,1,0,1
UTOP-OP1 DonorConnect,All Time,All Ethnicities,692,4,688
"
","
",White Non-Hispanic,455,3,452
"
","
",Black Non-Hispanic,19,0,19
"
","
",Hispanic/Latino,140,1,139
"
","
",Asian Non-Hispanic,23,0,23
"
","
",American Indian/Alaska Native Non-Hispanic,23,0,23
"
","
","
","
","
","
"
"
","
",Pacific Islander Non-Hispanic,26,0,26
"
","
",Multiracial Non-Hispanic,6,0,6
"
",< 30 Days,All Ethnicities,49,1,48
"
","
",White Non-Hispanic,32,0,32
"
","
",Black Non-Hispanic,4,0,4
"
","
",Hispanic/Latino,7,1,6
"
","
",Asian Non-Hispanic,3,0,3
"
","
",American Indian/Alaska Native Non-Hispanic,3,0,3
"
",30 to < 90 Days,All Ethnicities,78,0,78
"
","
",White Non-Hispanic,57,0,57
"
","
",Black Non-Hispanic,1,0,1
"
","
",Hispanic/Latino,11,0,11
"
","
",Asian Non-Hispanic,2,0,2
"
","
",American Indian/Alaska Native Non-Hispanic,3,0,3
"
","
",Pacific Islander Non-Hispanic,3,0,3
"
","
",Multiracial Non-Hispanic,1,0,1
"
",90 Days to < 6 Months,All Ethnicities,59,1,58
"
","
",White Non-Hispanic,40,1,39
"
","
",Hispanic/Latino,12,0,12
"
","
",Asian Non-Hispanic,1,0,1
"
","
",American Indian/Alaska Native Non-Hispanic,1,0,1
"
","
",Pacific Islander Non-Hispanic,4,0,4
"
","
",Multiracial Non-Hispanic,1,0,1
"
",6 Months to < 1 Year,All Ethnicities,154,1,153
"
","
",White Non-Hispanic,101,1,100
"
","
",Black Non-Hispanic,7,0,7
"
","
",Hispanic/Latino,30,0,30
"
","
",Asian Non-Hispanic,4,0,4
"
","
",American Indian/Alaska Native Non-Hispanic,4,0,4
"
","
",Pacific Islander Non-Hispanic,8,0,8
"
",1 Year to < 2 Years,All Ethnicities,181,0,181
"
","
",White Non-Hispanic,110,0,110
"
","
",Black Non-Hispanic,4,0,4
"
","
",Hispanic/Latino,40,0,40
"
","
",Asian Non-Hispanic,9,0,9
"
","
",American Indian/Alaska Native Non-Hispanic,8,0,8
"
","
",Pacific Islander Non-Hispanic,7,0,7
"
","
",Multiracial Non-Hispanic,3,0,3
"
",2 Years to < 3 Years,All Ethnicities,82,0,82
"
","
",White Non-Hispanic,47,0,47
"
","
",Black Non-Hispanic,2,0,2
"
","
","
","
","
","
"
"
","
",Hispanic/Latino,28,0,28
"
","
",Asian Non-Hispanic,2,0,2
"
","
",American Indian/Alaska Native Non-Hispanic,1,0,1
"
","
",Pacific Islander Non-Hispanic,1,0,1
"
","
",Multiracial Non-Hispanic,1,0,1
"
",3 Years to < 5 Years,All Ethnicities,66,1,65
"
","
",White Non-Hispanic,50,1,49
"
","
",Black Non-Hispanic,1,0,1
"
","
",Hispanic/Latino,10,0,10
"
","
",American Indian/Alaska Native Non-Hispanic,3,0,3
"
","
",Pacific Islander Non-Hispanic,2,0,2
"
",5 or More Years,All Ethnicities,23,0,23
"
","
",White Non-Hispanic,18,0,18
"
","
",Hispanic/Latino,2,0,2
"
","
",Asian Non-Hispanic,2,0,2
"
","
",Pacific Islander Non-Hispanic,1,0,1
VATB-OP1 LifeNet Health,All Time,All Ethnicities,1959,46,1913
"
","
",White Non-Hispanic,720,26,694
"
","
",Black Non-Hispanic,1073,16,1057
"
","
",Hispanic/Latino,83,2,81
"
","
",Asian Non-Hispanic,65,1,64
"
","
",American Indian/Alaska Native Non-Hispanic,3,1,2
"
","
",Pacific Islander Non-Hispanic,7,0,7
"
","
",Multiracial Non-Hispanic,8,0,8
"
",< 30 Days,All Ethnicities,100,2,98
"
","
",White Non-Hispanic,40,1,39
"
","
",Black Non-Hispanic,51,1,50
"
","
",Hispanic/Latino,3,0,3
"
","
",Asian Non-Hispanic,4,0,4
"
","
",American Indian/Alaska Native Non-Hispanic,1,0,1
"
","
",Multiracial Non-Hispanic,1,0,1
"
",30 to < 90 Days,All Ethnicities,154,3,151
"
","
",White Non-Hispanic,42,1,41
"
","
",Black Non-Hispanic,98,0,98
"
","
",Hispanic/Latino,7,2,5
"
","
",Asian Non-Hispanic,6,0,6
"
","
",Multiracial Non-Hispanic,1,0,1
"
",90 Days to < 6 Months,All Ethnicities,185,6,179
"
","
",White Non-Hispanic,69,3,66
"
","
",Black Non-Hispanic,93,3,90
"
","
",Hispanic/Latino,11,0,11
"
","
","
","
","
","
"
"
","
",Asian Non-Hispanic,8,0,8
"
","
",Pacific Islander Non-Hispanic,2,0,2
"
","
",Multiracial Non-Hispanic,2,0,2
"
",6 Months to < 1 Year,All Ethnicities,338,3,335
"
","
",White Non-Hispanic,122,1,121
"
","
",Black Non-Hispanic,184,2,182
"
","
",Hispanic/Latino,18,0,18
"
","
",Asian Non-Hispanic,11,0,11
"
","
",Multiracial Non-Hispanic,3,0,3
"
",1 Year to < 2 Years,All Ethnicities,456,6,450
"
","
",White Non-Hispanic,162,2,160
"
","
",Black Non-Hispanic,254,4,250
"
","
",Hispanic/Latino,23,0,23
"
","
",Asian Non-Hispanic,15,0,15
"
","
",Pacific Islander Non-Hispanic,1,0,1
"
","
",Multiracial Non-Hispanic,1,0,1
"
",2 Years to < 3 Years,All Ethnicities,307,10,297
"
","
",White Non-Hispanic,111,9,102
"
","
",Black Non-Hispanic,177,1,176
"
","
",Hispanic/Latino,8,0,8
"
","
",Asian Non-Hispanic,9,0,9
"
","
",American Indian/Alaska Native Non-Hispanic,1,0,1
"
","
",Pacific Islander Non-Hispanic,1,0,1
"
",3 Years to < 5 Years,All Ethnicities,294,12,282
"
","
",White Non-Hispanic,121,8,113
"
","
",Black Non-Hispanic,152,3,149
"
","
",Hispanic/Latino,9,0,9
"
","
",Asian Non-Hispanic,8,0,8
"
","
",American Indian/Alaska Native Non-Hispanic,1,1,0
"
","
",Pacific Islander Non-Hispanic,3,0,3
"
",5 or More Years,All Ethnicities,125,4,121
"
","
",White Non-Hispanic,53,1,52
"
","
",Black Non-Hispanic,64,2,62
"
","
",Hispanic/Latino,4,0,4
"
","
",Asian Non-Hispanic,4,1,3
WALC-OP1 LifeCenter Northwest,All Time,All Ethnicities,1329,35,1294
"
","
",White Non-Hispanic,719,14,705
"
","
",Black Non-Hispanic,127,2,125
"
","
",Hispanic/Latino,140,11,129
"
","
",Asian Non-Hispanic,247,3,244
"
","
",American Indian/Alaska Native Non-Hispanic,27,2,25
"
","
","
","
","
","
"
"
","
",Pacific Islander Non-Hispanic,59,1,58
"
","
",Multiracial Non-Hispanic,10,2,8
"
",< 30 Days,All Ethnicities,58,1,57
"
","
",White Non-Hispanic,26,0,26
"
","
",Black Non-Hispanic,7,1,6
"
","
",Hispanic/Latino,8,0,8
"
","
",Asian Non-Hispanic,11,0,11
"
","
",American Indian/Alaska Native Non-Hispanic,3,0,3
"
","
",Pacific Islander Non-Hispanic,3,0,3
"
",30 to < 90 Days,All Ethnicities,90,1,89
"
","
",White Non-Hispanic,50,0,50
"
","
",Black Non-Hispanic,7,0,7
"
","
",Hispanic/Latino,10,1,9
"
","
",Asian Non-Hispanic,18,0,18
"
","
",American Indian/Alaska Native Non-Hispanic,1,0,1
"
","
",Pacific Islander Non-Hispanic,4,0,4
"
",90 Days to < 6 Months,All Ethnicities,121,3,118
"
","
",White Non-Hispanic,75,1,74
"
","
",Black Non-Hispanic,10,0,10
"
","
",Hispanic/Latino,12,1,11
"
","
",Asian Non-Hispanic,10,1,9
"
","
",American Indian/Alaska Native Non-Hispanic,6,0,6
"
","
",Pacific Islander Non-Hispanic,6,0,6
"
","
",Multiracial Non-Hispanic,2,0,2
"
",6 Months to < 1 Year,All Ethnicities,208,12,196
"
","
",White Non-Hispanic,116,2,114
"
","
",Black Non-Hispanic,16,1,15
"
","
",Hispanic/Latino,26,5,21
"
","
",Asian Non-Hispanic,37,2,35
"
","
",American Indian/Alaska Native Non-Hispanic,5,1,4
"
","
",Pacific Islander Non-Hispanic,6,0,6
"
","
",Multiracial Non-Hispanic,2,1,1
"
",1 Year to < 2 Years,All Ethnicities,279,10,269
"
","
",White Non-Hispanic,161,7,154
"
","
",Black Non-Hispanic,20,0,20
"
","
",Hispanic/Latino,30,1,29
"
","
",Asian Non-Hispanic,51,0,51
"
","
",American Indian/Alaska Native Non-Hispanic,2,1,1
"
","
",Pacific Islander Non-Hispanic,13,1,12
"
","
",Multiracial Non-Hispanic,2,0,2
"
",2 Years to < 3 Years,All Ethnicities,205,3,202
"
","
","
","
","
","
"
"
","
",White Non-Hispanic,101,2,99
"
","
",Black Non-Hispanic,23,0,23
"
","
",Hispanic/Latino,14,1,13
"
","
",Asian Non-Hispanic,54,0,54
"
","
",American Indian/Alaska Native Non-Hispanic,5,0,5
"
","
",Pacific Islander Non-Hispanic,7,0,7
"
","
",Multiracial Non-Hispanic,1,0,1
"
",3 Years to < 5 Years,All Ethnicities,250,2,248
"
","
",White Non-Hispanic,125,1,124
"
","
",Black Non-Hispanic,29,0,29
"
","
",Hispanic/Latino,30,1,29
"
","
",Asian Non-Hispanic,45,0,45
"
","
",American Indian/Alaska Native Non-Hispanic,5,0,5
"
","
",Pacific Islander Non-Hispanic,15,0,15
"
","
",Multiracial Non-Hispanic,1,0,1
"
",5 or More Years,All Ethnicities,118,3,115
"
","
",White Non-Hispanic,65,1,64
"
","
",Black Non-Hispanic,15,0,15
"
","
",Hispanic/Latino,10,1,9
"
","
",Asian Non-Hispanic,21,0,21
"
","
",Pacific Islander Non-Hispanic,5,0,5
"
","
",Multiracial Non-Hispanic,2,1,1
WIDN-OP1 Versiti Wisconsin Inc,All Time,All Ethnicities,617,7,610
"
","
",White Non-Hispanic,328,1,327
"
","
",Black Non-Hispanic,160,4,156
"
","
",Hispanic/Latino,61,0,61
"
","
",Asian Non-Hispanic,61,2,59
"
","
",American Indian/Alaska Native Non-Hispanic,4,0,4
"
","
",Pacific Islander Non-Hispanic,2,0,2
"
","
",Multiracial Non-Hispanic,1,0,1
"
",< 30 Days,All Ethnicities,25,1,24
"
","
",White Non-Hispanic,15,0,15
"
","
",Black Non-Hispanic,6,1,5
"
","
",Hispanic/Latino,2,0,2
"
","
",Asian Non-Hispanic,1,0,1
"
","
",American Indian/Alaska Native Non-Hispanic,1,0,1
"
",30 to < 90 Days,All Ethnicities,42,3,39
"
","
",White Non-Hispanic,19,1,18
"
","
",Black Non-Hispanic,13,2,11
"
","
",Hispanic/Latino,7,0,7
"
","
",Asian Non-Hispanic,3,0,3
"
","
","
","
","
","
"
"
",90 Days to < 6 Months,All Ethnicities,61,1,60
"
","
",White Non-Hispanic,37,0,37
"
","
",Black Non-Hispanic,14,0,14
"
","
",Hispanic/Latino,4,0,4
"
","
",Asian Non-Hispanic,5,1,4
"
","
",Multiracial Non-Hispanic,1,0,1
"
",6 Months to < 1 Year,All Ethnicities,101,1,100
"
","
",White Non-Hispanic,47,0,47
"
","
",Black Non-Hispanic,34,0,34
"
","
",Hispanic/Latino,7,0,7
"
","
",Asian Non-Hispanic,11,1,10
"
","
",American Indian/Alaska Native Non-Hispanic,2,0,2
"
",1 Year to < 2 Years,All Ethnicities,157,1,156
"
","
",White Non-Hispanic,91,0,91
"
","
",Black Non-Hispanic,29,1,28
"
","
",Hispanic/Latino,20,0,20
"
","
",Asian Non-Hispanic,16,0,16
"
","
",Pacific Islander Non-Hispanic,1,0,1
"
",2 Years to < 3 Years,All Ethnicities,100,0,100
"
","
",White Non-Hispanic,49,0,49
"
","
",Black Non-Hispanic,27,0,27
"
","
",Hispanic/Latino,13,0,13
"
","
",Asian Non-Hispanic,9,0,9
"
","
",American Indian/Alaska Native Non-Hispanic,1,0,1
"
","
",Pacific Islander Non-Hispanic,1,0,1
"
",3 Years to < 5 Years,All Ethnicities,73,0,73
"
","
",White Non-Hispanic,39,0,39
"
","
",Black Non-Hispanic,17,0,17
"
","
",Hispanic/Latino,5,0,5
"
","
",Asian Non-Hispanic,12,0,12
"
",5 or More Years,All Ethnicities,58,0,58
"
","
",White Non-Hispanic,31,0,31
"
","
",Black Non-Hispanic,20,0,20
"
","
",Hispanic/Latino,3,0,3
"
","
",Asian Non-Hispanic,4,0,4
WIUW-IO1 UW Health Organ and Tissue Donation,All Time,All Ethnicities,661,5,656
"
","
",White Non-Hispanic,463,4,459
"
","
",Black Non-Hispanic,88,1,87
"
","
",Hispanic/Latino,33,0,33
"
","
",Asian Non-Hispanic,60,0,60
"
","
",American Indian/Alaska Native Non-Hispanic,12,0,12
"
","
","
","
","
","
"
"
","
",Multiracial Non-Hispanic,5,0,5
"
",< 30 Days,All Ethnicities,26,0,26
"
","
",White Non-Hispanic,22,0,22
"
","
",Black Non-Hispanic,3,0,3
"
","
",Asian Non-Hispanic,1,0,1
"
",30 to < 90 Days,All Ethnicities,55,0,55
"
","
",White Non-Hispanic,35,0,35
"
","
",Black Non-Hispanic,7,0,7
"
","
",Hispanic/Latino,5,0,5
"
","
",Asian Non-Hispanic,6,0,6
"
","
",American Indian/Alaska Native Non-Hispanic,1,0,1
"
","
",Multiracial Non-Hispanic,1,0,1
"
",90 Days to < 6 Months,All Ethnicities,48,1,47
"
","
",White Non-Hispanic,35,1,34
"
","
",Black Non-Hispanic,7,0,7
"
","
",Hispanic/Latino,2,0,2
"
","
",Asian Non-Hispanic,2,0,2
"
","
",American Indian/Alaska Native Non-Hispanic,1,0,1
"
","
",Multiracial Non-Hispanic,1,0,1
"
",6 Months to < 1 Year,All Ethnicities,131,2,129
"
","
",White Non-Hispanic,99,2,97
"
","
",Black Non-Hispanic,15,0,15
"
","
",Hispanic/Latino,3,0,3
"
","
",Asian Non-Hispanic,13,0,13
"
","
",American Indian/Alaska Native Non-Hispanic,1,0,1
"
",1 Year to < 2 Years,All Ethnicities,142,0,142
"
","
",White Non-Hispanic,97,0,97
"
","
",Black Non-Hispanic,21,0,21
"
","
",Hispanic/Latino,8,0,8
"
","
",Asian Non-Hispanic,13,0,13
"
","
",American Indian/Alaska Native Non-Hispanic,2,0,2
"
","
",Multiracial Non-Hispanic,1,0,1
"
",2 Years to < 3 Years,All Ethnicities,84,0,84
"
","
",White Non-Hispanic,59,0,59
"
","
",Black Non-Hispanic,8,0,8
"
","
",Hispanic/Latino,7,0,7
"
","
",Asian Non-Hispanic,7,0,7
"
","
",American Indian/Alaska Native Non-Hispanic,3,0,3
"
",3 Years to < 5 Years,All Ethnicities,111,2,109
"
","
",White Non-Hispanic,76,1,75
"
","
",Black Non-Hispanic,17,1,16
"
","
","
","
","
","
"
"
","
",Hispanic/Latino,2,0,2
"
","
",Asian Non-Hispanic,11,0,11
"
","
",American Indian/Alaska Native Non-Hispanic,3,0,3
"
","
",Multiracial Non-Hispanic,2,0,2
"
",5 or More Years,All Ethnicities,64,0,64
"
","
",White Non-Hispanic,40,0,40
"
","
",Black Non-Hispanic,10,0,10
"
","
",Hispanic/Latino,6,0,6
"
","
",Asian Non-Hispanic,7,0,7
"
","
",American Indian/Alaska Native Non-Hispanic,1,0,1